Mm, Mm^Xm, Mm^Xm, Mm^Xm, Mm, Mm, Mm, Mm, Mm, Mm, Mm, Hh, Mm, Mm, Mm, Mm, Mm, Mm, Mm, Mm, Hh, Mm, Mm, Mm, Mm, Mm, Mm, Mm, Mm, Mm, Mm, Mm^Xm, Mm^Xm, Mm^Xm, Mm^Xm
Mm, Mm^Xm, Mm^Xm, Mm^Xm, Mm, Mm, Mm, Mm, Mm, Mm, Mm, Hhd^Em, Mm, Mm, Mm, Mm, Mm, Mm, Mm, Mm, Hh, Mm, Mm, Mm, Mm, Mm, Mm, Mm, Mm, Mm, Mm, Mm^Xm, Mm^Xm, Mm^Xm, Mm^Xm
Mm, Mm^Xm, Mm^Xm, Mm^Xm, Mm, Mm, Md, Hhd, Mm, Mm, Hhd^Em, Hhd^Fmw, Hhd^Fdw, Mm, Hhd^Fp, Mm, Hh^Fp, Mm, Gs^Fp, Gs^Fp, Mm, Mm, Mm, Mm, Chr, Mm, Hh^Fdw, Mm, Hh^Fmw, Mm, Mm, Mm, Mm^Xm, Mm^Xm, Mm^Xm
Mm^Xm, Mm, Mm, Mm, Hhd^Fmw, Md, Md, Hhd^Es, Hhd, Md, Hhd^Vo, Hhd^Fdw, Md, Gd^Fp, Hhd^Em, Hhd^Emf, Hhd^Fp, Mm, Gs^Fmw, Gs^Fmw, Hh^Em, Hh, Hh, Mm, Hh, Chr, Hh, Hh^Fdw, Mm, Mm, Mm, Mm, Mm, Mm, Mm
Mm^Xm, Mm^Xm, Mm^Xm, Mm, Mm, Hhd^Fp, Hhd^Fp, Hhd^Fmw, Hhd, Hhd^Es, Hhd, Md, Re, Gd^Fdw, Gs^Fmw, Gd^Fmw, Hh^Fp, Hh^Em, Re, Hh, Re^Es, Mm, Re^Gvs, Re, Chr, Hh^Vhhr, Hh^Es, Hh, Re^Vht, Mm, Mm, Mm, Mm, Mm, Mm
Mm, Mm, Mm, Mm, Md, Hhd^Vo, Hhd^Fdw, Hhd^Fmw, Gd^Fdw, Cfr, Co, Cfr, Re^Edt, Re, Gd^Fmw, Gs^Fp, Gs^Fmw, Hh^Vhhr, Gd, Co, Re^Es, Re^Gvs, Re^Gvs, Re^Gvs, Re^Gvs, Chr, Hh, Rd, Re, Re^Es, Mm, Mm, Mm, Mm, Mm
Mm, Mm, Hhd^Fdw, Md, Md, Hhd, Hhd, Gd, Co, Cfr, Co, Re^Edt, Re^Edt, Gd^Fdw, Gd^Fdw, Gs^Fmw, Gd^Fp, Gd^Fmw, Gd^Fdw, Re, Re^Eff, Re^Eff, Re^Gvs, Re^Gvs, Re^Vwm, Re^Gvs, Re, Rd, Khr, Hh, Hh^Fdw, Mm, Mm, Mm, Mm
Mm, Hhd, Hhd^Fdw, Md, Cfr, Hhd^Es, Co, Re^Es, Re^Edt, 2 Ko, Re, Re, Gd^Fdw, Re, Gd^Em, Gd, Gd^Fmw, Gd^Fmw, Re^Eff, Re^Eff, Re^Gvs, Re^Gvs, Re^Gvs, Re^Gvs, Re^Gvs, Re^Es, Rd, Rd^Ecf, Chr, Hh^Fmw, Mm, Hh, Mm, Mm, Mm
Mm, Mm, Hhd, Cfr, Re, Co, Re, Re^Edt, Re^Edt, Co, Co, Re^Edt, Re, Re, Gd^Fdw, Gs, Gs, Gs, Gd, Re^Eff, Re^Eff, Re^Gvs, Re^Gvs, Re^Gvs, Re^Gvs, Re, 1 Re^Gvs, Re, Re^Vct, Hh, Hh^Fdw, Mm, Mm, Mm, Mm
Mm, Hhd^Vo, Hhd, Hhd, Hhd, Co, Gd, Gd^Fdw, Re, Re, Re, Re, Rd, Gd, Re^Gvs, Rd, Rd, Re^Gvs, Re^Gvs, Gd^Fdw, Re, Rd^Eff, Rd, Re^Gvs, Rd, Rd, Re^Gvs, Re^Gvs, Hh, Re, Hh, Hh, Mm, Mm, Mm
Hhd, Hhd^Fdw, Chr, Hhd^Es, Re^Es, Rb^Vo, Rb, Re, Gd^Fmw, Gd^Fdw, Gs^Fdw, Re, Rd, Re^Gvs, Re^Gvs, Re^Gvs, Gd^Vhr, Re^Gvs, Gd, Gd^Es, Rd, Rd, Rd, Rd, Re^Eff, Re^Vct, Re^Gvs, Re^Vct, Hh^Fdw, Hh, Mm, Hh^Fdw, Mm, Mm, Mm
Hh, Hhd^Fdw, Mm, Chr, Re, Re^Edt, Rb, Gd^Fdw, Gs^Fmw, Gs^Em, Gs^Fmw, Co, Re^Es, Re^Gvs, Re^Gvs, Re^Gvs, Gd, Rd, Rd, Rd, Re^Gvs, Rd, Re^Gvs, Re, Gd, Re^Eff, Re, Hh, Hh^Fdw, Co, Mm, Hh^Fdw, Mm, Mm, Mm
Hh^Fp, Mm, Gd^Fmw, Chr, Rb, Rb^Ecf, Rb^Edt, Re, Rd, Gd, Rd, Gd^Fmw, Re, Re^Gvs, Re^Gvs, Gd, Cfr, Rd, Rd, Re^Gvs, Re^Gvs, Re^Gvs, Re^Gvs, Re^Gvs, Gs^Fdw, Gd, Re^Gvs, Hh, Hh, Co, Mm, Mm, Mm, Mm, Mm
Hh^Fmw, Hh^Fp, Gd^Fmw, Re^Edt, Rd, Re^Edt, Re, Rd, Gd^Eff, Re, Gd, Re, Re, Re^Gvs, Re, Re^Es, Re^Es, Rd^Ecf, Rd, Re, Gd^Fdw, Re^Gvs, Gd^Fmw, Gs, Gs^Fdw, Re, Re^Gvs, Re^Gvs, Re^Gvs, Gd, Gd, Hh, Mm, Mm, Mm
Gll^Fmw, Gs^Fp, Hh, Rb^Vhr, Rd, Re, Re^Eff, Gd^Eff, Gs^Fdw, Gd^Em, Re^Gvs, Re^Gvs, Re^Gvs, Re^Wm, Re^Gvs, Re, Co, Re, Ko, Rd, Re, Gd^Fdw, Gd, Gd, Gs, Re^Eff, Re^Eff, Re^Gvs, Re^Eff, Re^Eff, Hh, Hh^Fmw, Hh^Fp, Mm, Mm
Gs^Fmw, Mm, Hh, Gd^Es, Re, Re, Re^Gvs, Re^Eff, Re, Gs^Fdw, Gs, Re^Gvs, Re^Gvs, Re^Gvs, Gs, Re, Re^Edt, Co, Gs^Em, Gd^Fdw, Gd, Re^Es, Re, Gs^Fmw, Gg^Fmw, Gs^Es, Gs, Re, Re^Vc, Hh, Hh^Em, Hh^Emf, Hh^Fmw, Mm, Mm
Gd^Es, Re, Rb^Vhr, Rd, Re^Gvs, Re^Gvs, Re^Gvs, Re^Gvs, Gs^Fdw, Gs^Fmw, Gd^Fdw, Gd, Gd^Fdw, Gd^Es, Rd, Rd, Gd^Edt, Gd^Edt, Gs, Hh, Hh, Gs^Fdw, Re, Gs^Fdw, Re^Gvs, Gg, Re^Gvs, Re^Gvs, Hh^Fdw, Hh^Fmw, Gs^Fmw, Hh^Fp, Hh^Fdw, Hh^Fp, Hh^Fdw
Re^Gvs, Re^Gvs, Re, Rd, Re^Es, Re^Gvs, Re^Gvs, Re^Gvs, Re^Gvs, Gs^Fmw, Rd, Gd, Gs^Fmw, Gd, Re, Gd, Gd^Fmw, Gs, Hh^Fdw, Hh^Fmw, Gll^Fdw, Rd, Gs, Hh^Es, Re^Gvs, Re^Gvs, Re^Gvs, Re^Gvs, Re^Gvs, Hh^Em, Gll^Fmw, Hh^Fdw, Gs^Fmw, Hh^Em, Hh
Rd, Re^Gvs, Gs^Es, Rd, Re, Re^Gvs, Re^Gvs, Re^Gvs, Re, Re, Rd, Gs^Fmw, Gs^Fp, Gs^Em, Re, Gs^Fmw, Hh^Fdw, Gs^Em, Gll^Fmw, Hh^Fp, Gll^Fmw, Rd, Hh^Fdw, Hh, Hh, Re^Gvs, Re, Re^Gvs, Re, Re, Re, Gs^Em, Re^Es, Re, Re
Hh^Fdw, Gs^Fdw, Co, Co, Co, Re, Gd, Rb^Vo, Rd, Rd^Es, Gs, Gll^Fmw, Gll^Fmw, Gs^Fp, Rd, Gs^Fp, Hh^Fp, Hh^Fmw, Hh^Fp, Gll^Fp, Gs^Fp, Rd, Rd, Mm, Mm, Hh^Es, Rd, Re, Gs^Fmw, Gll, Gll^Fdw, Re, Gs, Gll, Gs^Fdw
Hh, Hh^Fmw, Mm, Ko, Hh, Gs^Fmw, Gs^Es, Gs, Rd, Gd^Fdw, Gll^Fp, Gll^Fp, Gs^Fmw, Re^Es, Rd, Hh^Fmw, Mm, Gll^Em, Re, Gll^Fmw, Re^Gvs, Re^Gvs, Gg^Es, Hh, Hh, Hh, Re, Gs, Gs^Fmw, Gll^Fp, Hh^Fmw, Gll^Fmw, Hh^Emf, Hh^Em, Gs^Fmw
Hh^Fdw, Mm, Mm, Hh^Fdw, Hh^Vo, Hh^Emf, Gs, Chr, Rd, Gd^Fmw, Gs, Gll^Fp, Gs^Fmw, Re, Rd, Gll^Fmw, Hh, Re, Hh^Fmw, Re, Re^Gvs, Re^Gvs, Re^Gvs, Gg, Rd, Re, Gg, Gs^Fp, Gll^Fp, Hh^Fp, Hh^Fp, Hh, Mm, Hh^Fdw, Hh
Mm, Mm, Mm, Mm, Mm, Mm, Gg, Rd, Re^Gvs, Gll, Re^Gvs, Gs^Em, Gll^Fmw, Gll^Fmw, Re, Gg, Re, Re, Hh^Fmw, Re^Gvs, Re^Gvs, Re^Gvs, Re, Rd, Gs, Gg, Gs^Fmw, Gll^Em, Gs^Fms, Hh^Fms, Hh^Vhhr, Hh^Emf, Mm, Mm, Mm
Mm^Xm, Mm^Xm, Mm, Mm, Mm, Hh, Hh, Rd, Re^Gvs, Re^Gvs, Re^Gvs, Gs, Re^Gvs, Gs, Gs, Re, Hh, Gll^Fp, Gg^Fp, Gs^Fmw, Gll^Fp, Re, Gs, Re^Es, Cfr, Gs, Gs^Fp, Gs^Fp, Hh^Fp, Hh^Fms, Mm, Mm, Mm, Mm, Mm
Mm, Mm^Xm, Mm, Mm, Hh^Dr, Chr, Gs^Fmw, Rd, Rd^Es, Re^Gvs, Gs, Re, Re^Gvs, Re^Gvs, Re^Gvs, Re^Es, Re, Hh^Fmw, Gll^Fms, Hh^Fms, Hh^Fp, Hh, Hh^Fmw, Re, Rb^Vu, Gd, Gd^Fp, Cfr, Cfr, Hh, Mm, Mm, Mm, Mm, Mm
Mm, Mm, Hh^Fp, Hh, Khr, Chr, Gg^Fp, Gll^Fmw, Re, Gs, Gg^Fmw, Re^Gvs, Re^Gvs, Re^Gvs, Re^Wm, Re^Gvs, Re, Gs^Fp, Gs^Emf, Gs^Fms, Hh^Fp, Mm, Hh, Gd, Re, Re^Es, Gd, Hh, Cfr, 3 Kfr, Mm, Mm, Mm, Mm^Xm, Mm^Xm
Mm, Hh^Vhhr, Hh^Fms, Chr, Chr, Gg^Fms, Gs^Fp, Gll^Em, Re, Gll, Gll^Em, Gs^Fmw, Gs^Fmw, Re^Gvs, Re^Gvs, Rd, Rd, Gs^Em, Gs^Es, Hh^Fp, Gll^Em, Gs^Fmw, Re, Re, Re, Gll^Fmw, Gs^Fmw, Cfr, Cfr, Mm, Mm, Mm, Mm, Mm^Xm, Mm^Xm
Mm, Mm, Hh, Gll^Fp, Gll^Fms, Gs^Fms, Gg, Gg^Fp, Re, Gg^Fmw, Gll^Fp, Gll^Fp, Gs^Fp, Gs, Re^Gvs, Re^Gvs, Rd, Gg^Fp, Gll^Fp, Gg, Gs^Fp, Gg, Rd, Cfr, Cfr, Gll^Fp, Rb^Vu, Hh^Emf, Hh, Hh, Mm, Mm, Mm, Mm^Xm, Mm^Xm
Mm, Hh^Fms, Hh, Gll^Fp, Re^Gvs, Re^Gvs, Re^Gvs, Gg^Fp, Re, Gg^Fmw, Gg^Fmw, Gs^Fp, Gg^Fms, Gg^Em, Gg^Fp, Re, Rd, Gs, Gg^Fms, Hh^Fms, Re, Rd^Es, Hh, Hh, Gg, Re, Hh, Hh, Hh^Fmw, Mm, Mm, Mm, Mm, Mm, Mm
Hh^Fp, Hh^Fp, Gg^Fp, Re^Gvs, Re^Gvs, Re^Gvs, Re, Re, Re, Gg^Fp, Gg^Efm, Gg^Fms, Gg^Fp, Hh^Fms, Gg^Fms, Gg^Fp, Gg^Efm, Re, Re, Gg^Fp, Re, Re, Gll^Fmw, Gs^Fmw, Gg^Fp, Re, Hh^Fp, Hh, Mm, Mm, Mm, Mm, Mm^Xm, Mm, Mm
Gg^Fmw, Hh^Fp, Gg^Fmw, Re^Gvs, Re, Re, Re^Es, Re^Es, Gg^Fp, Re, Hh, Gs^Fp, Re^Gvs, Gg^Em, Hh^Fp, Gg^Em, Gg^Fp, Re, Gg^Em, Re, Gg^Fmw, Gll^Em, Gll^Fmw, Gs^Fms, Gg^Efm, Gg, Mm, Hh^Fp, Hh^Fmw, Mm, Mm^Xm, Mm^Xm, Mm, Mm, Mm
Hh, Hh, Rd, Rd, Gg^Em, Gg^Fms, Gg^Fms, Gg, Gs^Fp, Re, Re^Gvs, Re^Gvs, Re^Gvs, Re^Gvs, Hh^Fms, Hh^Fms, Gs^Fp, Re, Gg^Fp, Gs, Hh^Fp, Gg^Fp, Gg^Fms, Gs^Fms, Hh^Fp, Hh^Fp, Mm, Hh^Vhhr, Mm, Mm, Mm^Xm, Mm^Xm, Mm, Mm, Mm
Rd, Re, Gg^Fp, Gg^Es, Hh^Em, Gs^Fp, Gs^Fms, Gg^Fms, Gs^Fp, Hh^Vhhr, Hh^Emf, Re^Gvs, Re^Gvs, Gg^Fp, Gg^Fmw, Gs^Fms, Gs^Fp, Chr, Hh, Gs^Vhr, Hh^Fms, Hh^Fms, Gg^Fp, Gg^Fds, Gg^Fp, Hh^Fp, Mm, Mm, Mm, Mm, Gs^Fp, Hh^Fp, Hh^Fms, Gs^Fms, Hh^Fp
Re^Gvs, Gg^Fp, Gg^Fms, Hh, Gs^Fp, Gs^Fp, Hh^Fp, Gg^Fms, Hh, Hh^Emf, Hh, Hh, Mm, Hh, Gg, Gs^Fmw, Gs^Fp, Gs^Fp, Gll^Fp, Gg^Fp, Gg^Fp, Gg^Fp, Hh^Fp, Hh^Emf, Hh, Hh, Mm, Mm, Mm, Hh, Mm^Xm, Hh^Fms, Gs^Fp, Gs^Fp, Gs^Fp
