Mm, Mm, Mm, Mm^Xm, Mm^Xm, Mm^Xm, Mm, Mm, Mm, Mm, Mm, Mm, Mm, Gs^Fp, Mm, Mm, Mm, Mm, Mm, Mm, Mm, Mm, Hh, Mm, Mm, Mm, Mm, Mm, Mm, Mm, Mm, Mm, Mm, Mm^Xm, Mm^Xm, Mm^Xm, Mm^Xm
Mm, Mm, Mm, Mm^Xm, Mm^Xm, Mm^Xm, Mm, Mm, Mm, Mm, Mm, Mm, Mm, Gs^Fp, Mm, Mm, Mm, Mm, Mm, Mm, Mm, Mm, Hh, Mm, Mm, Mm, Mm, Mm, Mm, Mm, Mm, Mm, Mm, Mm^Xm, Mm^Xm, Mm^Xm, Mm^Xm
Mm, Mm, Mm, Mm^Xm, Mm^Xm, Mm^Xm, Mm, Mm, Mm, Hh^Vhh, Mm, Mm, Hh, Hh^Fp, Hh^Fp, Mm, Hh^Emf, Mm, Hh, Mm, Gs^Fp, Gs^Fp, Mm, Mm, Mm, Mm, Hh, Mm, Hh, Mm, Hh^Vhh, Mm, Mm, Mm, Mm^Xm, Mm^Xm, Mm^Xm
Mm, Mm, Mm^Xm, Mm, Mm, Mm, Hh, Mm, Mm, Hh^Emf, Hh, Mm, Hh^Vhh, Hh^Fp, Mm, Gs^Fp, Hh, Hh, Hh, Mm, Gs^Fp, Gs^Fp, Hh, Hh, Hh, Mm, Hh^Emf, Hh, Hh, Hh^Emf, Mm, Mm, Mm, Mm, Mm, Mm, Mm
Mm, Mm, Mm^Xm, Mm^Xm, Mm^Xm, Mm, Mm, Hh^Emf, Hh, Hh^Fp, Hh, Hh^Emf, Hh, Mm, Gs^Fp, Gs^Fp, Gll^Fp, Gs^Fp, Hh^Emf, Hh^Emf, Re, Hh, Gg^Es, Mm, Gg, Hh, Hh^Emf, Hh^Vhh, Hh, Hh, Gg, Mm, Mm, Mm, Mm, Mm, Mm
Mm, Mm, Mm, Mm, Mm, Mm, Mm, Hh, Hh^Fms, Hh^Fms, Gs^Fp, Gs^Fp, Chr, Re, Gs^Fms, Gll^Fp, Gll^Fp, Gll^Fp, Gll^Fp, Hh^Vhh, Gs^Fp, Gg, Gg, Gg, Re^Gvs, Hh, Gg, Hh^Emf, Hh, Rd, Re, Re, Mm, Mm, Mm, Mm, Mm
Mm, Mm, Mm, Mm, Hh^Fp, Mm, Mm, Hh, Hh, Gs^Fp, Chr, Chr, Chr, Re, Gll^Fp, Gll^Fp, Gll^Fms, Gll^Fms, Gll^Fp, Gs^Fp, Gs^Fms, Gg, Gg, Gg^Vh, Re^Gvs, Re^Gvs, Gg, Chr, Chr, Re, Khr, Hh, Hh, Mm, Mm, Mm, Mm
Mm, Mm, Mm, Hh, Hh^Fp, Mm, Gs^Fp, Gg^Vh, Gs^Fp, Re, Chr, 2 Khr, Chr, Gs^Fp, Gs^Fms, Re, Gs^Fp, Gll^Fms, Gll^Fp, Gs^Fms, Gg^Es, Gg, Re^Gvs, Re^Gvs, Re^Gvs, Re^Gvs, Re^Gvs, Gg, Rd, Rd, Chr, Hh, Mm, Hh, Mm, Mm, Mm
Mm, Mm, Mm, Mm, Hh, Gs^Fp, Gll^Fp, Gll^Fp, Gs^Fp, Chr, Gll^Fp, Chr, Chr, Gs^Fp, Re, Re, Gs^Fp, Gs^Fms, Gg, Gg, Gg, Gg, Re^Gvs, Re^Gvs, Re^Gvs, Re^Gvs, Re^Gvs, Re, 1 Gg, Gg, Gg, Hh, Hh, Mm, Mm, Mm, Mm
Mm, Mm, Mm, Hh^Vhh, Hh^Emf, Hh, Hh, Gs^Fms, Gs^Fp, Gll^Fp, Gll^Fms, Gll^Fp, Gs^Fms, Gs^Fp, Rd, Gs^Fp, Re^Gvs, Rd, Rd, Re^Gvs, Re^Gvs, Gg, Gg^Es, Gg, Rd, Re, Rd, Rd, Gg, Gg^Vh, Hh, Gg, Hh, Hh, Mm, Mm, Mm
Mm, Mm, Hh, Hh^Emf, Gg, Hh, Gs^Fp, Gg^Vh, Gs^Fp, Gs^Fp, Gll^Fp, Gll^Fms, Gll^Fp, Gll^Fp, Rd, Re^Gvs, Re^Gvs, Re^Gvs, Gg^Vh, Re^Gvs, Gg, Gg^Es, Rd, Rd, Gg^Vh, Rd, Gs^Fp, Re, Gg, Gg, Hh, Hh, Mm, Hh, Mm, Mm, Mm
Hh, Hh, Hh, Hh, Mm, Gg, Gg, Gs^Fp, Gg, Gs^Fms, Gll^Fp, Gll^Fp, Gll^Fp, Gll^Fp, Re, Re^Gvs, Re^Gvs, Re^Gvs, Gg, Rd, Re, Re, Re^Gvs, Gg, Re^Gvs, Gs^Fp, Gs^Fms, Gg, Gg, Hh, Hh, Hh, Mm, Hh, Mm, Mm, Mm
Hh, Hh, Hh^Fp, Mm, Gs^Fp, Gg, Gg, Gg^Es, Gg, Gg, Rd, Gg, Rd, Gs^Fp, Re, Re^Gvs, Re^Gvs, Gg, Chr, Rd, Gg, Re^Gvs, Re^Gvs, Re^Gvs, Re^Gvs, Gs^Fp, Gg, Gg, Re^Gvs, Hh, Hh, Hh, Mm, Mm, Mm, Mm, Mm
Hh, Hh^Fp, Hh^Fp, Hh^Fp, Gs^Fp, Gg, Gg^Vh, Gg, Re, Rd, Gg, Re, Gg, Re, Gg^Vh, Re^Gvs, Re^Gvs, Re, Re, Chr, Rd, Gg, Re^Gvs, Re^Gvs, Re^Gvs, Gg, Gs^Fp, Gg, Re^Gvs, Re^Gvs, Re^Gvs, Gg, Gg, Hh, Mm, Mm, Mm
Gs^Fp, Gs^Fp, Gll^Fp, Gll^Fp, Hh, Gg, Re, Re, Gg, Gg, Gll^Fp, Gg, Re^Gvs, Re^Gvs, Re^Gvs, Gg^Wm, Re^Gvs, Re, Chr, Re, Khr, Rd, Re, Re^Gvs, Re, Gg, Gg, Gg, Gg, Gg, Gg^Vh, Gg, Hh, Hh^Emf, Hh^Vhh, Mm, Mm
Gg, Gg, Gs^Fp, Mm, Hh, Gg^Es, Re, Re^Gvs, Re^Gvs, Gg^Es, Gll^Fp, Gs^Fp, Gg, Re^Gvs, Re^Gvs, Re^Gvs, Gg, Re, Re, Chr, Gg, Gg, Gg, Rd, Re, Gg, Gg, Gg^Es, Gg, Gg, Gg, Hh, Hh, Hh^Emf, Hh, Mm, Mm
Gg, Gg, Gg^Es, Gg, Gg^Vh, Rd, Re^Gvs, Re^Gvs, Gg, Gs^Fp, Gs^Fp, Gs^Fms, Gs^Fp, Gg, Gg, Gg^Es, Rd, Rd, Gg^Efm, Gg, Gg, Gg, Gg, Gg^Vh, Re, Gg, Re^Gvs, Gg, Re^Gvs, Re^Gvs, Hh, Hh, Gg, Hh, Hh, Hh, Hh
Re, Re, Re^Gvs, Re^Gvs, Gs, Rd, Re, Re^Gvs, Re^Gvs, Re^Gvs, Re^Gvs, Gs^Fp, Rd, Gg, Gg, Gg, Re^Gvs, Gg, Gg, Gg, Gs^Fp, Gs^Fms, Gll^Fp, Rd, Gg, Gg^Es, Re^Gvs, Re^Gvs, Re^Gvs, Re^Gvs, Re^Gvs, Hh, Cer, Hh, Gg, Hh, Hh
Rd, Rd, Rd, Re^Gvs, Chr, Rd, Rd, Re^Gvs, Re^Gvs, Re^Gvs, Gg, Re^Gvs, Rd, Gg, Gs^Fp, Re^Gvs, Re^Gvs, Gg, Re^Gvs, Gg^Vh, Gll^Fp, Gs^Fp, Gll^Fp, Rd, Gg, Re^Gvs, Gg, Re^Gvs, Rd, Re, Rd, Cer, 3 Ker, Cer, Rd, Rd, Rd
Hh, Hh^Emf, Hh^Vhh, Chr, Khr, Chr, Gg, Re, Gg, Gg^Vh, Rd, Rd, Gs^Fms, Gll^Fp, Gll^Fp, Gs^Fp, Re^Gvs, Re^Gvs, Gg, Gs^Fms, Gll^Fp, Gll^Fms, Gs^Fp, Rd, Rd, Gg, Gg^Efm, Gg, Rd, Gg^Vh, Gg, Cer^Ecf, Cer, Cer, Gg, Gg, Gg
Mm, Mm, Hh, Hh, Mm, Chr, Hh, Gg, Gg^Es, Gg, Rd, Gll^Fp, Gll^Fp, Gll^Fp, Gs^Fms, Gg, Rd, Re^Gvs, Gg, Gg, Rd, Gll^Fms, Re^Gvs, Re^Gvs, Gg, Rd, Re, Rd, Re, Gg, Gs^Fp, Gs^Fp, Hh^Fp, Gg, Hh^Emf, Hh^Vhh, Gg
Mm, Mm, Hh, Mm, Mm, Hh, Hh^Vhh, Hh^Emf, Gg, Gg, Rd, Gs^Fp, Gg^Vh, Gll^Fp, Gg^Es, Gg, Rd, Gg^Es, Gs, Rd, Gg, Rd, Re^Gvs, Re^Gvs, Re^Gvs, Gg, Rd, Re, Gg, Gs^Fp, Gs^Fp, Hh^Fp, Hh, Hh, Mm, Hh, Hh
Mm, Mm, Mm, Mm, Mm, Mm, Mm, Mm, Gg, Rd, Re^Gvs, Gg, Re^Gvs, Gg^Wm, Gg, Gg, Rd, Gg, Rd, Rd, Gg, Re^Gvs, Re^Gvs, Re^Gvs, Re, Rd, Gg, Gg, Gs^Fp, Gg, Gs^Fp, Hh, Hh^Vhh, Hh^Emf, Mm, Mm, Mm
Mm^Xm, Mm^Xm, Mm^Xm, Mm^Xm, Mm, Mm, Mm, Hh, Hh, Rd, Re^Gvs, Re^Gvs, Re^Gvs, Gg, Re^Gvs, Gg^Efm, Gg, Rd, Gg, Gg, Gg, Gg, Gll^Fp, Gg, Re, Gg^Vh, Gg, Gg^Es, Gs^Fp, Gs^Fp, Hh, Hh, Mm, Mm, Mm, Mm, Mm
Mm^Xm, Mm^Xm, Mm, Mm, Mm, Mm, Chr, Chr, Gll^Fp, Rd, Rd, Re^Gvs, Gg^Vh, Gg, Re^Gvs, Re^Gvs, Re^Gvs, Rd, Re, Gg, Gll^Fp, Gs^Fp, Gll^Fp, Gg, Re, Re^Gvs, Re^Gvs, Gg, Gs^Fp, Chr, Chr, Hh, Mm, Mm, Mm, Mm, Mm
Mm, Mm, Mm, Mm, Hh^Fp, Chr, Khr, Hh^Fp, Gll^Fp, Gll^Fp, Re, Gg, Gg, Re^Gvs, Re^Gvs, Re^Gvs, Rd, Re^Gvs, Re, Gg, Gg^Vh, Gll^Fp, Gll^Fp, Gg, Re, Re^Gvs, Re^Gvs, Re^Gvs, Gg, Hh, Chr, Khr, Mm, Mm, Mm, Mm^Xm, Mm^Xm
Mm, Mm, Mm, Hh^Vhh, Hh^Fms, Chr, Chr, Gs^Fms, Gs^Fms, Gg, Re, Gg, Gll^Fp, Gs^Fp, Gs^Fp, Re^Gvs, Re^Gvs, Rd, Rd, Gg, Gg^Es, Gll^Fp, Gll^Fp, Gg, Re, Re^Gvs, Re^Gvs, Re^Gvs, Gg, Hh, Chr, Mm, Mm, Mm, Mm, Mm^Xm, Mm^Xm
Mm, Mm, Mm, Mm, Hh, Gll^Fp, Gs^Fms, Gs^Fms, Gg^Vh, Rd, Re^Gvs, Gg, Gll^Fp, Gll^Fp, Gs^Fp, Gs^Fp, Re^Gvs, Re^Gvs, Rd, Gg, Gg, Gg, Gs^Fp, Gg, Rd, Gg, Gg, Gg, Gg^Es, Hh^Emf, Hh, Hh, Mm, Mm, Mm, Mm^Xm, Mm^Xm
Mm, Mm, Mm, Hh, Hh, Gll^Fp, Re^Gvs, Re^Gvs, Rd, Rd, Re^Gvs, Gg, Gg, Gs^Fp, Gg, Gg^Vh, Gg, Re^Gvs, Rd, Gg, Gg, Gg, Rd, Rd, Gg, Gg, Re^Gvs, Gg, Hh, Hh, Hh, Mm, Mm, Mm, Mm, Mm, Mm
Mm, Mm, Hh, Hh, Gg, Re^Gvs, Re^Gvs, Re^Gvs, Re, Re^Gvs, Rd, Gg, Gg^Efm, Gg, Gg, Gg, Gg, Gg, Gg^Efm, Re, Re, Gg, Rd, Re^Gvs, Re^Gvs, Gg^Wm, Gg^Vh, Re^Gvs, Hh, Hh, Mm, Mm, Mm, Mm, Mm^Xm, Mm, Mm
Mm, Mm, Gg, Hh, Gg, Re^Gvs, Rd, Rd, Re, Re^Gvs, Gg, Re^Gvs, Re^Gvs, Gg, Re^Gvs, Gg^Es, Gg, Gg^Efm, Gg, Re, Rd, Re, Gg, Re^Gvs, Re^Gvs, Re^Gvs, Gg^Efm, Re^Gvs, Mm, Hh, Hh, Mm, Mm^Xm, Mm^Xm, Mm, Mm, Mm
Gg, Gg, Gg^Vh, Gg, Re, Rd, Gg, Gg^Vh, Gs^Fp, Gg, Gs^Fp, Gg, Re^Gvs, Re^Gvs, Re^Gvs, Re^Gvs, Gg, Gg^Efm, Gs^Fp, Rd, Gg, Gg, Gg, Gg, Gg, Gg^Efm, Gg, Hh, Mm, Hh, Mm, Mm, Mm^Xm, Mm^Xm, Mm, Mm, Mm
Rd, Rd, Rd, Re, Gg, Gg^Es, Gs^Fp, Gs^Fp, Gs^Fp, Gs^Fp, Gs^Fp, Hh^Vhh, Hh^Emf, Re^Gvs, Re^Gvs, Gg, Gg, Gs^Fp, Gs^Fp, Rd, Gg, Gg^Vh, Gg^Es, Gg, Gg, Gg, Gg, Hh, Mm, Mm, Mm, Mm, Gs^Fp, Gs^Fp, Gs^Fp, Gs^Fp, Gs^Fp
Re^Gvs, Re^Gvs, Re^Gvs, Re^Gvs, Gg, Gs^Fp, Gs^Fp, Gs^Fp, Hh^Fp, Gs^Fp, Hh, Hh^Emf, Hh, Hh, Mm, Hh, Gg, Gs^Fp, Gs^Fp, Gs^Fp, Gll^Fp, Gg, Gg, Gg, Hh^Vhh, Hh^Emf, Hh, Hh, Mm, Mm, Mm, Hh, Mm^Xm, Gs^Fp, Gs^Fp, Gs^Fp, Gs^Fp
Re^Gvs, Re^Gvs, Re^Gvs, Gg, Gg, Gs^Fp, Hh, Hh^Fp, Hh^Fp, Hh, Mm, Hh, Mm, Mm, Hh, Hh^Fms, Hh^Fp, Gs, Gll^Fp, Gll^Fp, Re, Gll^Fp, Gs^Fp, Gg, Chr, Hh, Khr, Mm, Mm, Mm, Mm, Mm, Mm, Mm^Xm, Mm^Xm, Mm, Mm
Re^Gvs, Re^Gvs, Gg^Vh, Gg, Gg, Gs^Fp, Mm, Mm, Mm, Hh, Mm, Mm, Mm, Mm, Mm, Hh, Hh^Fms, Gll^Fp, Gll^Fp, Gll^Fp, Rd, Gll^Fp, Gs^Fp, Gg, Gg, Chr, Hh, Hh, Mm, Mm, Mm, Mm, Mm, Mm, Mm, Mm, Mm
Re^Gvs, Re^Gvs, Gg, Gg, Gg, Gs^Fp, Mm, Mm, Mm, Hh, Mm, Mm, Mm, Mm, Mm, Hh, Chr, Gs^Fp, Gs^Fp, Gs^Fp, Rd, Gs^Fp, Gs^Fp, Gg, Gg, Hh, Hh, Hh, Mm, Mm, Mm, Mm, Mm, Mm, Mm, Mm, Mm
