Qxu, Qxu, Qxu, Qxu, Qxu, Qxu, Qxu, Qxu, Qxu, Qxu, Xoa, Xoa, Xoa, Xu, Xu, Xu, Xu, Xu, Xu, Xu, Xu, Xu, Xu, Xu, Xu, Xoa, Uu, Uu, Xoa, Xu, Xu, Xu, Xu, Xu, Xu, Xu, Xu, Xu, Xu, Xu, Xu, Xu, Xu, Xu, Xu, Xu
Qxu, Qxu, Qxu, Qxu, Qxu, Qxu, Qxu, Qxu, Qxu, Qxu, Xoa, Xoa, Xoa, Xu, Xu, Xu, Xu, Xu, Xu, Xu, Xu, Xu, Xu, Xu, Xu, Xoa, Ias, Ias, Xoa, Xu, Xu, Xu, Xu, Xu, Xu, Xu, Xu, Xu, Xu, Xu, Xu, Xu, Xu, Xu, Xu, Xu
Qxu, Qxu, Qxu, Qxu, Ias, Qxu, Qxu, Qxu, Xoa, Xoa, Xu, Xu, Xoa, Xoa, Xu, Xu, Xoa, Xu, Xu, Xu, Xu, Xu, Xu, Xu, Xoa, Xoa, Ias^Pr\o, Uu, Xoa, Xu, Xoa, Xu, Xu, Xu, Xu, Xu, Xu, Xu, Xu, Xu, Xu, Xu, Xu, Xu, Xu, Xu
Qxu, Qxu, Qxu, Ias, Ias^Ii, Ias, Xoa, Xoa, Xoa, Xoa, Xoa, Xoa, Ias, Xoa, Xoa, Xoa, Ias, Xoa, Xoa, Xu, Xu, Xoa, Xoa, Xoa, Uu, Ias, Uu, Uu^Pr\o, Xoa, Xoa, Xoa, Xu, Xu, Xu, Xu, Xu, Xu, Xu, Xu, Xu, Xu, Xu, Xu, Xu, Xu, Xu
Qxu, Qxu, Qxu, Ias, Ias, Ias, Xu, Xoa, Xoa, Xoa, Ias, Ias, Ias, Ias, Xoa, Ias, Ias, Ias, Xoa, Xu, Xu, Xoa, Ias, Uu, Ias, Ias, Xoa, Xoa, Xoa, Xoa, Xu, Xu, Xu, Xu, Xu, Xu, Xu, Xu, Xu, Xu, Xu, Xu, Xu, Xu, Xu, Xu
Xoa, Qxu, Xoa, Xoa, Uu, Ias, Xoa, Xoa, Xoa, Xoa, Ias, Ias, Ias, Ias, Ias, Ias^Pr\, Xoa, Ias^Pr/, Ias, Xoa, Xoa, Xoa, Ias, Ias, Xoa, Xoa, Xoa, Xoa, Xu, Xu, Xu, Xu, Xu, Xu, Xu, Xu, Xu, Xu, Uu^Tf, Xu, Xu, Xu, Xu, Xu, Xu, Xu
Xoa, Xoa, Xoa, Xoa, Ias, Uu, Ias, Xoa, Xoa, Xoa, Xoa, Ias, Ias, Ias, Ias, Ias, Ias, Ias, Ias, Ias, Ias, Ias^Pr\, Ias^Pr\, Uu, Xoa, Xoa, Xoa, Xu, Xu, Xu, Xu, Xu, Xu, Xu, Xu, Xu, Ss^Vhs, Uu^Tf, Chs, Sm, Rb, Xu, Xu, Xu, Sm, Uu
Xoa, Xu, Xoa, Xoa, Xoa, Ias, Ias, Uu, Ias, Xoa, Ias, Ias^Pr\o, Ias^Pr\o, Ias, Ias, Ias, Ias, Ias, Ias, Ias, Ias, Ias, Ias, Xoa, Xoa, Xoa, Xoa, Xu, Xu, Xu, Xu, Xu, Xu, Xu, Xu, Xu, Ss, Chs, Khs, Chs, Rb, Uu, Uu, Sm^Vhs, Rb, Uu
Xoa, Xoa, Xu, Xoa, Xoa, Xoa, Xoa, Uu, Ias, Ias, Uu, Ias, Xoa, Xoa, Xoa, Ias, Ias, Ias, Ias, Ias, Ias, Ias, Ias, Ias, Ias, Xoa, Xu, Xu, Xoa, Xu, Xu, Xu, Xu, Xu, Xu, Xu, Rb, Chs, Chs, Chs, Uu^Tf, Uu^Tf, Ss, Uu, Rb, Xu
Xu, Xu, Xu, Xu, Xu, Xoa, Xoa, Xoa, Xoa, Uu, Xoa, Xoa, Xoa, Xoa, Xoa, Xoa, Xoa, Ias, Ias, Ias, Ias, Ias, Ias, Ias, Ias^Pr/o, Xoa, Xoa, Xoa, Ias, Xoa, Xoa, Xu, Xu, Xu, Xu, Xu, Ss^Vhs, Rb, Ss, Rb, Rb, Sm, Sm, Ss, Xu, Xu
Xu, Xu, Xu, Xu, Xu, Xu, Xu, Xoa, Xoa, Xoa, Xoa, Xoa, Xu, Xu, Xoa, Xoa, Ias, Ias^Pr\o, Ias^Pr\o, Ias, Ias, Ias, Xoa, Ias^Pr/o, Ias, Ias, Ias, Uu, Uu, Ias, Uu, Xoa, Xoa, Xoa, Xoa, Xu, Xu, Uu^Tf, Uu^Tf, Ss, Sm, Uu^Tf, Ss^Vhs, Xu, Xu, Xu
Xu, Xu, Xu, Xu, Xoa, Xoa, Xoa, Xoa, Xoa, Xoa, Xu, Xu, Xu, Xu, Xoa, Uu, Uu, Ias, Xoa, Xoa, Xoa, Xoa, Xu, Xoa, Xoa, Uu, Uu, Ias, Xoa, Ias, Uu, Ias, Ias^Pr/o, Xoa, Xu, Xu, Xu, Xu, Xu, Sm, Rb, Ss, Uu, Xu, Xu, Xu
Xu, Xu, Xu, Xoa, Ias, Uu, Uu, Xoa, Xoa, Xoa, Xoa, Xu, Xu, Xu, Xoa, Ias, Ias, Xoa, Xu, Xu, Xu, Xu, Xu, Xu, Xu, Xoa, Xoa, Xoa, Xu, Xoa, Xoa, Ias^Pr/o, Gg, Gg, Gg, Xu, Xu, Xu, Xu, Sm, Rb, Uu^Tf, Uu^Tf, Uu, Xu, Xu
Xu, Xu, Xu, Xoa, Uu, Ias, Xoa, Xu, Xu, Xoa, Xoa, Xu, Xoa, Xoa, Ias, Uu, Ias, Xoa, Xu, Xu, Xu, Xu, Xu, Xu, Ias, Xu, Xu, Xu, Xu, Xoa, Xu, Gg, Gg, Gg, Gg, Xu, Xu, Xu, Xu, Uu, Uu, Rb, Sm, Sm, Xu, Xu
Xu, Xu, Xu, Xoa, Uu, Ias, Uu, Xoa, Xoa, Xu, Xoa, Xoa, Gg, Ias^Pr\o, Ias^Pr\o, Uu, Xoa, Xoa, Xoa, Xu, Xu, Xu, Xu, Ias, Uu, Ias, Xu, Xu, Xu, Xu, Xu, Xu, Gg, Rb, Gg, Gg, Xu, Xu, Xu, Xu, Ss, Sm, Uu, Ss^Vhs, Xu, Xu
Xu, Xu, Xu, Xoa, Xoa, Ias, Uu, Ias, Xoa, Xoa, Xoa, Gg, Gg, Gg, Gg, Xoa, Xoa, Xoa, Gg, Xoa, Xoa, Xu, Xu, Xu, Ias, Uu, Xu, Xu, Xu, Xu, Xu, Xu, Re, Re, Gg, Gg, Gg, Xu, Xu, Xu, Uu, Sm, Ss, Xu, Xu, Xu
Xu, Xu, Xu, Xu, Xu, Xoa, Ias^Pw/o, Ias^Pw/o, Uu, Xoa, Qxu, Qxu, Qxu^Bcx/, Gg, Gg, Gg, Gg, Gg, Gg, Gg, Gg, Xoa, Xu, Ias, Uu, Ias, Xu, Xu, Gs, Gs, Re, Re, Gg, Gg, Gg, Gg, Gg, Gg, Gg, Uu, Gg, Ss, Uu, Xu, Xu, Xu
Xu, Xu, Xu, Xu, Xu, Xoa, Xoa, Uu, Uh, Cud, Qxu, Qxu, Qxu, Qxu, Xu, Gg, Gg, Gs, Qxu, Gg, Gg, Xoa, Xoa, Xoa, Ias^Pw|, Xoa, Xoa, Xoa, Gg, Re, Gg, Re, Gg, Gg, Xu, Gs, Xu, Gg, Gg, Gg, Gg, Gg, Gg, Xu, Xu, Xu
Xu, Xu, Xu, Xu, Xoa, Xoa, Uh, Uu^Ebn, Ur, Uh, Ur, Qxu, Cud, Xu, Xu, Qxu, Qxu, Qxu, Qxu, Gs, Gg, Re, Re, Xoa, Ias, Xoa, Re, Re, Gg, Re, Gg, Gg, Gg, Xu, Xu, Xu, Xu, Xu, Gg, Gg, Gg, Gg, Xu, Xu, Xu, Xu
Xu, Xu, Xu, Xoa, Xoa, Uu^Vud, Ur, Uu, Ur, Uu, Uu^Vud, Uh, Ur, Xu, Xu, Xu, Uh, Qxu, Qxu, Qxu, Gg, Re, Gg, Re, Gg, Ias, Ur, Re, Wwg, Gg, Gg, Gg, Gg, Gg, Xu, Xu, Xu, Uu, Gg, Gg, Gg, Xu, Xu, Xu, Xu, Xu
Xu, Xu, Xu, Xoa, Xoa, Uu, Ur, Uh, Uu, Rb, Rb, Ur^Ebn, Uu, Uh, Uh^Tf, Xu, Xu, Uu^Tf, Qxu, Qxu, Gg, Gg, Gg, Gg, Wwg, Ur, Wwg, Wwg, Ur, Wwg, Wwg, Gg, Gg, Gg, Gg, Xu, Xu, Gg, Gg, Gg, Gg, Xu, Xu, Xu, Xu, Xu
Xu, Xu, Xu, Xoa, Xoa, Xoa, Xoa, Uu, Uu, Ur, Ur, Uu, Ur, Uu^Vud, Rb, Xu, Xu, Xu, Xu, Gg, Gg, Gg, Wwg, Wwg, Gg, Wwg, Gg, Gg, Ur, Ur, Ur, Wwg, Re, Gg, Gg, Xu, Xu, Xu, Gg, Gg, Gg, Gg, Xu, Xu, Xu, Xu
Xu, Xu, Xu, Xoa, Xoa, Xoa, Rb, Ur^Pr\o, Ur^Pr\o, Uu, Xoa, Uh, Uh, Ur, Rb, Uu^Tf, Xu, Xu, Xu, Gg, Ur, Ur, Wwg, Gg, Gg, Ur, Gg, Gg, Gg, Ur, Gg, Wwg, Re, Re, Gg, Xu, Xu, Xu, Xu, Gg, Gg, Gg, Gg, Xu, Xu, Xu
Xu, Xu, Xu, Xoa, Xoa, Ur, Uu, Rb, Xoa, Xoa, Cud, Cud^Ebn, Cud, Ur, Uu^Vud, Ur, Uu, Xu, Gg, Gg, Wwg, Wwg, Gg, Gg, Gg, Gg, Gg, Gg, Gg, Gg, Gg, Wwg, Re, Gg, Gg, Gg, Xu, Xu, Xu, Xu, Gg, Gg, Gg, Xu, Xu, Xu
Xu, Xu, Xu, Xoa, Xoa, Uu, Ur, Xoa, Uu^Vud, Ur, Cud, Kud, Cud, Uu, Uu, Ur, Ur, Gg, Gg, Gg, Wwg, Gg, Gg, Gg, Gg, Gg, Gg, Gg, Gg, Gg, Wwg, Wwg, Gg, Gg, Gg, Gg, Gg, Xu, Xu, Gg, Gg, Gg, Gg, Xu, Xu, Xu
Xu, Xu, Xu, Xoa, Xoa, Ur, Uu, Xoa, Xoa, Ur^Ebn, Uu^Vud, Cud, Xoa, Xoa, Ur, Uu^Ebn, Uu, Ur, Gg, Gg, Wwg, Gg, Gg, Gg, Gg, Gg, Gg, Gg, Gg, Ur, Wwg, Re, Gg, Gg, Gg, Gg, Xu, Xu, Xu, Gg, Gg, Gg, Gg, Gg, Xu, Xu
Xu, Xu, Xu, Xoa, Xoa, Rb, Uu, Ur, Uu^Pr/o, Xoa, Xoa, Xoa, Ur, Ur^Pr\o, Uu^Pr\o, Ur, Xoa, Gg, Gg, Gg, Gg, Wwg, Gg, Gg, Gg, Gg, Gg, Gg, Wwg, Wwg, Re, Gg, Gg, Gg, Gg, Gg, Gg, Xu, Gg, Gg, Gg, Gg, Gg, Gg, Xu, Xu
Xu, Xu, Xu, Xu, Xoa, Xoa, Xoa, Ur^Pr/o, Rb, Uu, Ur, Uu, Rb, Uu, Ur, Xoa, Xoa, Xu, Gg, Gg, Gg, Wwg, Wwg, Gg, Gg, Gg, Ur, Ur, Wwg, Wwg, Gg, Gg, Xu, Xu, Ur, Gg, Gg, Gg, Gg, Gg, Gg, Gg, Gg, Gg, Xu, Xu
Xu, Xu, Xu, Xu, Uu^Tf, Xoa, Ur, Rb, Uu, Ur, Ur, Uu^Tf, Rb, Uu^Tf, Xoa, Xoa, Xoa, Xu, Gg, Gg, Gg, Gg, Gg, Wwg, Wwg, Wwg, Wwg, Wwg, Wwg, Gg, Gg, Gg, Xu, Xu, Xu, Ur, Xu, Gg, Gg, Gg, Gg, Gg, Gg, Xu, Xu, Xu
Uu, Xu, Rb, Uu, Rb, Ur, Uu, Ur, Uu^Tf, Uu, Xu, Xu, Xu, Xoa, Xu, Xoa, Xu, Xu, Xu, Gg, Gg, Gg, Gg, Gg, Gg, Re, Gg, Wwg, Gg, Gg, Gg, Xu, Xu, Xu, Xu, Xu, Xu, Xu, Gg, Gg, Gg, Gg, Gg, Xu, Xu, Xu
Uu, Ur, Rb, Rb, Xu, Uu, Xu, Xu, Xu, Xu, Xu, Xu, Xu, Xu, Xu, Xu, Xu, Xu, Xu, Xu, Xu, Xu, Xu, Gg, Gg, Re, Gg, Gg, Gg, Gg, Gg, Ur, Ur, Xu, Gg, Xu, Uu, Gg, Gg, Gg, Gg, Gg, Gg, Xu, Xu, Xu
Ur, Ur, Uu^Tf, Xu, Xu, Xu, Xu, Xu, Xu, Xu, Qxu, Xu, Gg, Xu, Gg, Gg, Gg, Xu, Xu, Xu, Xu, Xu, Xu, Xu, Gg, Re, Gg, Gg, Gg, Gg, Gg, Gg, Gg, Gg, Gg, Gg, Gg, Gg, Gg, Gg, Gg, Gg, Gg, Xu, Xu, Xu
Xu, Uu, Xu, Xu, Xu, Xu, Xu, Xu, Qxu, Qxu, Wog, Qxu, Gg, Gg, Gg, Gg, Gg, Gg, Gg, Xu, Uu^Tf, Xu, Xu, Xu, Gg, Re, Gg, Xu, Xu, Gg, Xu, Gg, Gg, Gg, Gg, Gg, Xu, Gg, Gg, Gg, Xu, Gg, Xu, Xu, Xu, Xu
Xu, Xu, Xu, Xu, Xu, Xu, Xu, Qxu, Qxu, Wog, Wog, Wog, Wwg, Gg, Gg, Gg, Gg, Gg, Gg, Xu, Ur, Uh, Xu, Ur, Gg, Gg, Gg, Xu, Xu, Xu, Xu, Xu, Ur, Gg, Gg, Xu, Xu, Xu, Xu, Xu, Xu, Xu, Xu, Xu, Xu, Xu
Wog, Xu, Xu, Xu, Uu, Xu, Xu, Xu, Qxu, Wog, Uu^Tf, Uu, Wwg, Uu^Tf, Re, Re, Gg, Gg, Gg, Xu, Xu, Uu, Xu, Ur, Gg, Gg, Xu, Xu, Xu, Xu, Uu^Tf, Ur, Uu, Uu, Ur, Xu, Xu, Xu, Xu, Xu, Xu, Xu, Xu, Xu, Xu, Xu
Wog, Xu, Xu, Xu, Uu^Tf, Uu, Xu, Xu, Gg, Wwg, Wwg, Wwg, Wwg, Uh, Wwg, Gg, Xu, Gg, Gg, Gg, Xu, Xu, Xu, Ur, Gg, Gg, Xu, Xu, Xu, Xu, Uu^Tf, Uu, Uh, Uu, Uu^Tf, Ur, Uu^Vu, Xu, Xu, Xu, Xu, Xu, Xu, Xu, Xu, Xu
Wog, Wog, Xu, Xu, Xu, Xu, Xu, Gg, Gg, Gg, Re, Uh, Wog, Wog, Wog, Xu, Xu, Xu, Rb, Rb, Rb, Xu, Xu, Xu, Gg, Gg, Ur, Xu, Xu, Xu, Uu, Uu, Uh, Qxu, Qxu, Uu^Tf, Uu, Uu, Uu, Xu, Qxu, Xu, Xu, Xu, Xu, Xu
Wog, Wog, Wog, Xu, Xu, Xu, Xu, Gg, Gg, Gg, Re, Wwg, Wog, Wog, Xu, Xu, Xu, Rb, Gg, Gg, Ur, Ur, Ur, Rb, Rb, Ur, Ur, Xu, Xu, Xu, Xu, Uu, Uu^Vu, Qxu, Qxu, Qxu, Qxu, Uu^Tf, Ur, Uu, Qxu, Qxu, Qxu, Xu, Xu, Xu
Wog, Wog, Wog, Xu, Xu, Xu, Xu, Xu, Gg, Gg, Re, Gg, Xu, Xu, Xu, Xu, Xu, Gg, Ur, Rb, Rb, Gg, Rb, Rb, Gg, Rb, Xu, Xu, Xu, Xu, Xu, Uu, Ur, Uh, Uh, Qxu, Qxu, Uu^Tf, Uh, Ur, Uu, Qxu, Qxu, Xu, Xu, Xu
Xu, Wog, Wog, Wog, Wog, Xu, Xu, Xu, Xu, Gg, Re, Xu, Uu, Uu, Xu, Xu, Rb, Rb, Ur, Ur, Gg, Rb, Rb, Gg, Gg, Qxu, Qxu, Xu, Uu, Xu, Xu, Xu, Qxu, Ur, Uu, Qxu, Qxu, Qxu, Uh, Uu^Vu, Uu, Qxu, Qxu, Xu, Xu, Xu
Xu, Xu, Wog, Wog, Wog, Wog, Xu, Xu, Xu, Gg, Re, Xu, Xu, Uu^Tf, Xu, Xu, Ur, Ur, Ur, Ur, Gg, Ur, Ur, Rb, Xu, Qxu, Qxu, Qxu, Uh, Uh, Xu, Xu, Qxu, Uu^Tf, Uu^Tf, Uu^Vu, Qxu, Qxu, Qxu, Uu, Uu, Uh, Qxu, Qxu, Xu, Xu
Xu, Xu, Xu, Wwg, Wwg, Wog, Wwg, Xu, Xu, Gg, Re, Gg, Xu, Xu, Xu, Xu, Xu, Ur, Xu, Gg, Gg, Gg, Xu, Xu, Xu, Xu, Qxu, Qxu, Ur, Xu, Xu, Xu, Qxu, Qxu, Uu, Ur, Ur, Qxu, Qxu, Uu, Uu, Uh, Qxu, Qxu, Xu, Xu
Xu, Xu, Ss^Vhs, Ss, Wwg, Wwg, Ss, Xu, Xu, Gg, Gg, Re, Re, Xu, Xu, Xu, Xu, Xu, Xu, Xu, Xu, Xu, Xu, Xu, Re, Qxu, Qxu, Qxu, Qxu, Xu, Xu, Qxu, Qxu, Qxu, Qxu, Uh, Uu, Uu, Cte, Ur, Ur, Qxu, Qxu, Xu, Xu, Xu
Xu, Xu, Ss, Ss, Wwg, Ss, Ss, Xu, Xu, Xu, Gg, Re, Re, Re, Re, Ur, Gg, Xu, Qxu, Xu, Xu, Xu, Re, Uu, Gg, Re, Gg, Qxu, Xu, Xu, Xu, Xu, Xu, Qxu, Qxu, Uh, Uu, Cte, Kte, Cte, Uu, Uu, Xu, Xu, Xu, Xu
Xu, Xu, Uu^Tf, Uu, Ur, Wwg, Uu, Uu^Tf, Xu, Xu, Xu, Gg, Gg, Re, Gg, Re, Re, Qxu, Qxu^Bp/, Uu, Qxu^Bp\, Qxu, Qxu^Bp/, Gg, Xu, Re, Re, Gg, Gg, Xu, Xu, Xu, Xu, Qxu, Qxu, Qxu, Uu, Cte, Cte, Cte, Ur, Uu, Xu, Xu, Xu, Xu
Xu, Xu, Xu, Uu^Tf, Ss^Vhs, Wwg, Wwg, Uh, Xu, Xu, Uu^Tf, Xu, Xu, Xu, Xu, Gg, Gg, Re, Qxu, Qxu, Qxu, Uu, Qxu, Qxu, Xu, Xu, Gg, Re, Gg, Xu, Xu, Xu, Xu, Xu, Qxu, Qxu, Uu, Uu, Uu^Vu, Ur, Uu, Uu^Vu, Xu, Xu, Xu, Xu
Xu, Xu, Xu, Ss, Ss, Uu, Ss, Ss, Xu, Xu, Uu, Uh, Xu, Xu, Xu, Xu, Xu, Qxu, Xu, Xu, Xu, Qxu, Qxu, Xu, Qxu, Xu, Gg, Re, Gg, Xu, Xu, Xu, Xu, Xu, Xu, Qxu, Xu, Uu, Uu, Uu, Ur, Uu, Uu, Xu, Uu, Xu
Xu, Xu, Xu, Xu, Uu, Ur, Uh, Xu, Xu, Xu, Xu, Xu, Gg, Xu, Xu, Xu, Xu, Xu, Xu, Xu, Gg, Qxu, Qxu, Qxu, Qxu, Gg, Re, Re, Gg, Xu, Xu, Xu, Xu, Xu, Xu, Xu, Xu, Xu, Xu, Xu, Xu, Ur, Uu, Ur, Ur, Ur
Xu, Xu, Xu, Xu, Uu^Tf, Ss, Ur, Xu, Gg, Gg, Re, Gg, Re, Gg, Re, Xu, Re, Gg, Re, Re, Re, Re, Qxu^Bcx/, Qxu^Bcx/, Qxu, Qxu, Uu, Gg, Uu, Xu, Xu, Xu, Qxu, Qxu, Qxu, Xu, Uu^Tf, Xu, Xu, Xu, Xu, Xu, Xu, Uu, Xu, Uu
Xu, Xu, Xu, Xu, Xu, Uh, Rb, Rb, Re, Re, Gg, Re, Gg, Re, Gg, Re, Gg, Re, Gg, Rb, Rb, Gg, Gg, Qxu, Xu, Xu, Xu, Uu, Gg, Xu, Xu, Xu, Qxu, Uu, Qxu^Bs\, Uu^Tf, Uh, Uh, Xu, Xu, Xu, Xu, Xu, Xu, Xu, Xu
Xu, Xu, Xu, Xu, Xu, Xu, Rb, Re, Xu, Xu, Xu, Gg, Uh, Uu^Tf, Gg, Gs, Xu, Xu, Xu, Rb, Xu, Rb, Rb, Gg, Gg, Xu, Gg, Rb, Rb, Gg, Xu, Xu, Xu, Qxu, Uu, Uu, Rb, Uu, Xu, Xu, Xu, Xu, Xu, Xu, Xu, Xu
Xu, Xu, Xu, Xu, Xu, Xu, Gg, Re, Xu, Uu^Tfi, Ur, Xu, Uu, Uh, Uu, Xu, Xu, Xu, Xu, Xu, Xu, Xu, Rb, Gg, Gg, Rb, Rb, Rb, Gg, Gg, Gg, Xu, Xu, Uu^Tf, Uh, Rb, Uh, Uu, Uu^Tf, Xu, Xu, Xu, Xu, Xu, Xu, Xu
Xu, Xu, Xu, Xu, Gg, Gg, Re, Re, Xu, Uh, Xu, Xu, Ss, Wwf, Wwf, Xu, Uu^Tf, Xu, Xu, Xu, Uh, Xu, Xu, Rb, Xu, Rb, Gg, Gg, Gg, Gg, Gg, Xu, Xu, Uh, Rb, Uu, Uu^Tf, Rb, Uh, Xu, Xu, Xu, Xu, Xu, Xu, Xu
Xu, Xu, Xu, Xu, Re, Re, Xu, Xu, Xu, Xu, Rb, Uu, Uu^Tf, Ss, Uu, Uh, Ss, Sm, Xu, Xu, Uu^Tf, Uu, Xu, Xu, Xu, Xu, Xu, Xu, Xu, Gg, Xu, Xu, Xu, Xu, Xu, Uu, Rb, Uh, Uu, Xu, Xu, Xu, Xu, Xu, Xu, Xu
Xu, Xu, Xu, Gg, Re, Gg, Xu, Xu, Xu, Uu^Tf, Sm, Ss, Ss, Sm, Wwf, Ss, Uu, Sm^Vhs, Xu, Xu, Xu, Xu, Xu, Xu, Gg, Xu, Xu, Xu, Xu, Xu, Xu, Xu, Uh^Tf, Xu, Uu, Uh, Uu, Uu^Tf, Uu, Uu^Tf, Xu, Xu, Xu, Xu, Xu, Xu
Xu, Xu, Xu, Gg, Gg, Re, Xu, Xu, Xu, Ss^Vhs, Ss, Uu^Tf, Uh, Sm, Xu, Wwf, Xu, Xu, Xu, Xu, Xu, Xu, Gg, Gg, Re, Gg, Re, Gg, Gg, Xu, Xu, Uh, Uu^Tf, Uh, Ur, Uu, Xu, Rb, Rb, Uu^Tf, Uh, Xu, Xu, Xu, Xu, Xu
Xu, Xu, Xu, Gg, Gg, Re, Re, Xu, Xu, Xu, Xu, Xu, Xu, Xu, Xu, Xu, Xu, Xu, Gg, Gg, Gg, Gg, Re, Re, Gg, Re, Gg, Re, Re, Gg, Uh, Ur, Uu, Ur, Uu^Tf, Xu, Xu, Uh, Uu, Uu, Uh, Xu, Xu, Xu, Xu, Xu
Xu, Xu, Xu, Gg, Gg, Gg, Re, Xu, Xu, Xu, Xu, Xu, Xu, Xu, Xu, Xu, Gg, Gg, Gg, Gg, Re, Re, Xu, Gg, Rb, Gg, Xu, Gg, Xu, Re, Uu, Ur, Uu^Tf, Uu, Xu, Xu, Xu, Xu, Xu, Uu^Tf, Xu, Xu, Xu, Xu, Xu, Xu
Xu, Xu, Xu, Xu, Gg, Gg, Re, Xu, Xu, Xu, Xu, Xu, Re, Xu, Re, Gg, Re, Re, Re, Re, Xu, Xu, Xue, Xue, Uue, Uue, Xue, Xu, Xu, Xu, Xu, Uh, Uu, Uh, Xu, Xu, Xu, Xu, Xu, Xu, Xu, Xu, Xu, Xu, Xu, Xu
Xu, Xu, Xu, Xu, Gg, Gg, Gg, Re, Re, Re, Re, Re, Gg, Gg, Gg, Re, Xu, Xu, Xu, Xu, Xu, Xu, Xue, Qlf, Qlf, Rb, Uue^Tf, Xue, Xue, Xu, Xu, Uu^Tf, Rb, Rb, Uu, Xu, Uu^Tf, Xu, Xu, Xu, Xu, Xu, Xu, Xu, Xu, Xu
Xu, Xu, Ur, Xu, Xu, Gg, Gg, Gg, Gg, Gg, Gg, Gg, Gg, Gg, Gg, Xu, Xu, Xu, Xue, Xu, Xue, Xue, Uue, Uhe, Rb, Uue, Uue, Uhe, Xue, Xu, Xu, Xu, Xu, Uu, Uh, Ur, Ur, Uu^Tf, Uh, Xu, Xu, Xu, Xu, Xu, Xu, Xu
Xu, Xu, Uu, Xu, Xu, Xu, Xu, Gg, Xu, Gg, Gg, Gg, Gg, Gg, Xu, Xu, Xue, Xue, Qlf, Xue, Qlf, Qlf, Uue^Tf, Rb, Uhe, Uue^Tf, Qlf, Uue^Tf, Qlf, Xue, Xue, Xu, Xu, Xu, Xu, Uh, Uu^Tf, Uu, Uu, Uh, Xu, Xu, Mm^Xm, Mm^Xm, Mm^Xm, Xu
Xu, Xu, Xu, Xu, Uh, Xu, Xu, Xu, Xu, Xu, Xu, Xu, Xu, Xu, Xu, Xu, Xue, Qlf, Uue^Tf, Uhe, Uhe, Uue, Rb, Uhe, Qlf, Uue, Qlf, Rb, Uue, Qlf, Xue, Xu, Xu, Xu, Xu, Uu, Ur, Ur, Ur, Uh, Hhd, Xu, Mm^Xm, Mm^Xm, Mm^Xm, Mm^Xm
Xu, Xu, Xu, Uu, Xu, Ur, Uu^Tf, Xu, Xu, Xu, Xu, Uu, Uu^Tf, Xu, Xu, Xu, Xue, Qlf, Uue, Rb, Qlf, Rb, Xue, Uue^Tf, Qlf, Uue, Uhe, Rb, Uue^Tf, Qlf, Xue, Xu, Uu^Tf, Uu, Xu, Uh, Uh, Uu, Hhd, Hh, Hhd, Md^Xm, Mm, Mm, Mm, Mm
Xu, Xu, Xu, Uu^Tf, Uh, Uu, Xu, Xu, Xu, Xu, Xu, Uh, Xu, Xu, Xu, Xu, Xu, Xue, Xue, Xue, Xue, Xue, Xu, Xue, Xue, Qlf, Xue, Uhe, Xue, Xue, Xu, Xu, Xu, Uh, Xu, Xu, Hhd, Hh^Dr, Mm, Mm, Hhd^Ecf, Gll, Hhd, Md^Xm, Hh, Gll^Fp
Xu, Xu, Xu, Xu, Uu, Uu^Tf, Xu, Xu, Xu, Xu, Xu, Xu, Xu, Xu, Xu, Xu, Xu, Xu, Xu, Xu, Xu, Xu, Xu, Xu, Xu, Xue, Xu, Xue, Xu, Xu, Xu, Xu, Xu, Xu, Mm^Xm, Xu, Md^Xm, Hh, Gll, Mm, Mm, Rb, 1 Gll^Dr, Hh, Gs^Fms, Gll^Fp
Xu, Xu, Xu, Xu, Xu, Xu, Xu, Xu, Xu, Xu, Xu, Xu, Xu, Xu, Xu, Xu, Xu, Xu, Xu, Xu, Xu, Xu, Xu, Xu, Xu, Xu, Xu, Xu, Xu, Xu, Xu, Xu, Xu, Mm^Xm, Mm^Xm, Mm^Xm, Mm, Mm, Gs^Fms, Hh, Gll^Fp, Rb, Gll, Gll, Hhd, Hh
Xu, Xu, Xu, Xu, Xu, Xu, Xu, Xu, Xu, Xu, Xu, Xu, Xu, Xu, Xu, Xu, Xu, Xu, Xu, Xu, Xu, Xu, Xu, Xu, Xu, Xu, Xu, Xu, Xu, Xu, Xu, Xu, Xu, Mm^Xm, Mm^Xm, Mm, Mm, Mm, Gg, Gll^Fp, Hh, Hh, Gg, Hh, Hhd, Hh
