Qxu, Qxu, Qxu, Qxu, Qxu, Qxu, Qxu, Qxu, Qxu, Qxu, Xoa, Xoa, Xoa, Xu, Xu, Xu, Xu, Xu, Xu, Xu, Xu, Xu, Xu, Xu, Xu, Xoa, Uu, Uu, Xoa, Xu, Xu, Xu, Xu, Xu, Xu, Xu, Xu, Xu, Xu, Xu, Xu, Xu, Xu, Xu, Xu, Xu
Qxu, Qxu, Qxu, Qxu, Qxu, Qxu, Qxu, Qxu, Qxu, Qxu, Xoa, Xoa, Xoa, Xu, Xu, Xu, Xu, Xu, Xu, Xu, Xu, Xu, Xu, Xu, Xu, Xoa, Ias, Ias, Xoa, Xu, Xu, Xu, Xu, Xu, Xu, Xu, Xu, Xu, Xu, Xu, Xu, Xu, Xu, Xu, Xu, Xu
Qxu, Qxu, Qxu, Qxu, Ias, Qxu, Qxu, Qxu, Xoa, Xoa, Xu, Xu, Xoa, Xoa, Xu, Xu, Xoa, Xu, Xu, Xu, Xu, Xu, Xu, Xu, Xoa, Xoa, Ias^Pr\o, Uu, Xoa, Xu, Xoa, Xu, Xu, Xu, Xu, Xu, Xu, Xu, Xu, Xu, Xu, Xu, Xu, Xu, Xu, Xu
Qxu, Qxu, Qxu, Ias, Ias^Ii, Ias, Xoa, Xoa, Xoa, Xoa, Xoa, Xoa, Ias, Xoa, Xoa, Xoa, Ias, Xoa, Xoa, Xu, Xu, Xoa, Xoa, Xoa, Uu, Ias, Uu, Uu^Pr\o, Xoa, Xoa, Xoa, Xu, Xu, Xu, Xu, Xu, Xu, Xu, Xu, Xu, Xu, Xu, Xu, Xu, Xu, Xu
Qxu, Qxu, Qxu, Ias, Ias, Ias, Xu, Xoa, Xoa, Xoa, Ias, Ias, Ias, Ias, Xoa, Ias, Ias, Ias, Xoa, Xu, Xu, Xoa, Ias, Uu, Ias, Ias, Xoa, Xoa, Xoa, Xoa, Xu, Xu, Xu, Xu, Xu, Xu, Xu, Xu, Xu, Xu, Xu, Xu, Xu, Xu, Xu, Xu
Xoa, Qxu, Xoa, Xoa, Uu, Ias, Xoa, Xoa, Xoa, Xoa, Ias, Ias, Ias, Ias, Ias, Ias^Pr\, Xoa, Ias^Pr/, Ias, Xoa, Xoa, Xoa, Ias, Ias, Xoa, Xoa, Xoa, Xoa, Xu, Xu, Xu, Xu, Xu, Xu, Xu, Xu, Xu, Xu, Uu^Tf, Xu, Xu, Xu, Xu, Xu, Xu, Xu
Xoa, Xoa, Xoa, Xoa, Ias, Uu, Ias, Xoa, Xoa, Xoa, Xoa, Ias, Ias, Ias, Ias, Ias, Ias, Ias, Ias, Ias, Ias, Ias^Pr\, Ias^Pr\, Uu, Xoa, Xoa, Xoa, Xu, Xu, Xu, Xu, Xu, Xu, Xu, Xu, Xu, Ss^Vhs, Uu^Tf, Chs, Sm, Rb, Xu, Xu, Xu, Sm, Uu
Xoa, Xu, Xoa, Xoa, Xoa, Ias, Ias, Uu, Ias, Xoa, Ias, Ias^Pr\o, Ias^Pr\o, Ias, Ias, Ias, Ias, Ias, Ias, Ias, Ias, Ias, Ias, Xoa, Xoa, Xoa, Xoa, Xu, Xu, Xu, Xu, Xu, Xu, Xu, Xu, Xu, Ss, Chs, Khs, Chs, Rb, Uh, Uu, Sm^Vhs, Rb, Uu
Xoa, Xoa, Xu, Xoa, Xoa, Xoa, Xoa, Uu, Ias, Ias, Uu, Ias, Xoa, Xoa, Xoa, Ias, Ias, Ias, Ias, Ias, Ias, Ias, Ias, Ias, Ias, Xoa, Xu, Xu, Xoa, Xu, Xu, Xu, Xu, Xu, Xu, Xu, Rb, Chs, Chs, Chs, Uu^Tf, Uu^Tf, Ss, Uu, Rb, Xu
Xu, Xu, Xu, Xu, Xu, Xoa, Xoa, Xoa, Xoa, Uu, Xoa, Xoa, Xoa, Xoa, Xoa, Xoa, Xoa, Ias, Ias, Ias, Ias, Ias, Ias, Ias, Ias^Pr/o, Xoa, Xoa, Xoa, Ias, Xoa, Xoa, Xu, Xu, Xu, Xu, Xu, Ss^Vhs, Rb, Ss, Rb, Rb, Sm, Sm, Ss, Xu, Xu
Xu, Xu, Xu, Xu, Xu, Xu, Xu, Xoa, Xoa, Xoa, Xoa, Xoa, Xu, Xu, Xoa, Xoa, Ias, Ias^Pr\o, Ias^Pr\o, Ias, Ias, Ias, Xoa, Ias^Pr/o, Ias, Ias, Ias, Uu, Uu, Ias, Uu, Xoa, Xoa, Xoa, Xoa, Xu, Xu, Uu^Tf, Uu^Tf, Ss, Sm, Uu^Tf, Ss^Vhs, Xu, Xu, Xu
Xu, Xu, Xu, Xu, Xoa, Xoa, Xoa, Xoa, Xoa, Xoa, Xu, Xu, Xu, Xu, Xoa, Uu, Uu, Ias, Xoa, Xoa, Xoa, Xoa, Xu, Xoa, Xoa, Uu, Uu, Ias, Xoa, Ias, Uu, Ias, Ias^Pr/o, Xoa, Xu, Xu, Xu, Xu, Xu, Sm, Rb, Ss, Uu, Xu, Xu, Xu
Xu, Xu, Xu, Xoa, Ias, Uu, Uu, Xoa, Xoa, Xoa, Xoa, Xu, Xu, Xu, Xoa, Ias, Ias, Xoa, Xu, Xu, Xu, Xu, Xu, Xu, Xu, Xoa, Xoa, Xoa, Xu, Xoa, Xoa, Ias^Pr/o, Uh, Uu, Uu^Tf, Xu, Xu, Xu, Xu, Sm, Rb, Uu^Tf, Uu^Tf, Uh, Xu, Xu
Xu, Xu, Xu, Xoa, Uu, Ias, Xoa, Xu, Xu, Xoa, Xoa, Xu, Xoa, Xoa, Ias, Uu, Ias, Xoa, Xu, Xu, Xu, Xu, Xu, Xu, Ias, Xu, Xu, Xu, Xu, Xoa, Xu, Uu^Tf, Uu, Ias, Uh, Xu, Xu, Xu, Xu, Uh, Uu, Rb, Sm, Sm, Xu, Xu
Xu, Xu, Xu, Xoa, Uu, Ias, Uu, Xoa, Xoa, Xu, Xoa, Xoa, Uh, Ias^Pr\o, Ias^Pr\o, Uu, Xoa, Xoa, Xoa, Xu, Xu, Xu, Xu, Ias, Uu, Ias, Xu, Xu, Xu, Xu, Xu, Xu, Uh, Ias, Uu^Tf, Uh, Xu, Xu, Xu, Xu, Ss, Sm, Uu, Ss^Vhs, Xu, Xu
Xu, Xu, Xu, Xoa, Xoa, Ias, Uu, Ias, Xoa, Xoa, Xoa, Uu^Tf, Uh^Ebn, Uu, Uu, Xoa, Xoa, Xoa, Uu^Tf, Xoa, Xoa, Xu, Xu, Xu, Ias, Uu, Xu, Xu, Xu, Xu, Xu, Xu, Uu, Uu, Ur, Uu, Uu^Tf, Xu, Xu, Xu, Uu^Tf, Sm, Ss, Xu, Xu, Xu
Xu, Xu, Xu, Xu, Xu, Xoa, Ias^Pw/o, Ias^Pw/o, Uu, Xoa, Qxu, Qxu, Qxu^Bcx/, Ur, Ur, Uu^Tf, Ur, Uh, Uu, Uh^Ebn, Uu, Xoa, Xu, Ias, Uu, Ias, Xu, Xu, Uh, Uu^Tf, Uu^Vu, Ias, Ias, Uu, Uh, Ur, Uu, Uu, Uu^Tf, Uu, Ur, Ss, Uh, Xu, Xu, Xu
Xu, Xu, Xu, Xu, Xu, Xoa, Xoa, Uu, Uh, Cud, Qxu, Qxu, Qxu, Qxu, Xoa, Uh, Uu^Tf, Ur, Qxu, Ur, Ur, Xoa, Xoa, Xoa, Ias^Pw|, Xoa, Xoa, Xoa, Uu, Uu, Ias, Uh, Uu, Uu^Tf, Xu, Uh, Xu, Uh, Uu, Uu, Uh, Ur, Uu^Tf, Xu, Xu, Xu
Xu, Xu, Xu, Xu, Xoa, Xoa, Uh, Uu^Ebn, Ur, Uh, Ur, Qxu, Cud, Xoa, Xu, Qxu, Qxu, Qxu, Qxu, Uu^Tf, Uu, Uu, Uh, Xoa, Ias, Xoa, Uu, Uu^Tf, Uu, Ias, Uu^Tf, Uu, Uh, Xu, Xu, Xu, Xu, Xu, Rb, Uu, Uu, Uu, Xu, Xu, Xu, Xu
Xu, Xu, Xu, Xoa, Xoa, Uu^Vud, Ur, Uu, Ur, Uu, Uu^Vud, Uh, Ur, Xoa, Xoa, Xoa, Uh, Qxu, Qxu, Qxu, Uu^Vu, Ur, Ur, Uu, Uu, Ias, Ss, Uu, Wwg^Bcx|, Uu, Ss, Uu, Uh, Uu^Tf, Xu, Xu, Xu, Uu^Tf, Uu, Rb, Uu^Tf, Xu, Xu, Xu, Xu, Xu
Xu, Xu, Xu, Xoa, Xoa, Uu, Ur, Uh, Uu, Rb, Rb, Ur^Ebn, Uu, Uh, Uh^Tf, Xoa, Xoa, Uu^Tf, Qxu, Qxu, Uu^Tf, Uu, Uu, Uu, Wwg, Ss, Wwg, Wwg, Ur, Wwg, Wwg, Ss, Rb, Uu, Uu^Tf, Xu, Xu, Uh, Uu^Vu, Uu, Uh, Xu, Xu, Xu, Xu, Xu
Xu, Xu, Xu, Xoa, Xoa, Xoa, Xoa, Uu, Uu, Ur, Ur, Uu, Ur, Uu^Vud, Rb, Xoa, Xoa, Xoa, Xoa, Uu, Ur, Ur, Wwg^Bcx\, Wwg, Uh, Wwg, Uu, Ias, Uh, Uu^Tf, Ur, Wwg^Bcx/, Uu, Rb, Uu, Xu, Xu, Xu, Uh, Rb, Rb, Uu^Tf, Xu, Xu, Xu, Xu
Xu, Xu, Xu, Xoa, Xoa, Xoa, Rb, Ur^Pr\o, Ur^Pr\o, Uu, Xoa, Uh, Uh, Ur, Rb, Uu^Tf, Xoa, Xoa, Xoa, Uu, Ss, Ss, Wwg, Ias, Uu^Tf, Rb, Rb, Uu, Uu, Uh, Ias, Wwg, Uu, Uh, Uh, Xu, Xu, Xu, Xu, Uh, Uu, Uu, Uu^Tf, Xu, Xu, Xu
Xu, Xu, Xu, Xoa, Xoa, Ur, Uu, Rb, Xoa, Xoa, Cud, Cud^Ebn, Cud, Ur, Uu^Vud, Ur, Uu, Xoa, Uh, Uu, Wwg, Wwg, Uu, Uu, Uu, Ias, Uh, Ias, Uu, Ias, Ias, Wwg, Ss, Uu^Tf, Rb, Uu^Tf, Xu, Xu, Xu, Xu, Sm, Rb, Uh, Xu, Xu, Xu
Xu, Xu, Xu, Xoa, Xoa, Uu, Ur, Xoa, Uu^Vud, Ur, Cud, Kud, Cud, Uu, Uu, Ur, Ur, Uu, Uu, Ur, Wwg^Bcx/, Ias, Uh, Ias, Uu, Qxu, Qxu, Uh, Uu^Tf, Ias, Wwg, Wwg, Ss, Uu, Rb, Uu, Uh, Xu, Xu, Uu^Tf, Rb, Sm, Uu^Vu, Xu, Xu, Xu
Xu, Xu, Xu, Xoa, Xoa, Ur, Uu, Xoa, Xoa, Ur^Ebn, Uu^Vud, Cud, Xoa, Xoa, Ur, Uu^Ebn, Uu, Ur, Uu^Tf, Ur, Wwg, Uu^Tf, Ias, Ias, Uh, Qxu, Ias, Uu, Uh, Ur, Wwg^Bcx\, Uu, Rb, Uu, Uh, Uu^Tf, Xu, Xu, Xu, Uh, Rb, Uu^Tf, Uh, Uu^Tf, Xu, Xu
Xu, Xu, Xu, Xoa, Xoa, Rb, Uu, Ur, Uu^Pr/o, Xoa, Xoa, Xoa, Ur, Ur^Pr\o, Uu^Pr\o, Ur, Xoa, Uu^Tf, Uu, Uu, Ss, Wwg, Uu^Tf, Ur, Uh, Ias, Uu^Tf, Uu, Wwg, Wwg, Ss, Rb, Uh, Uu^Tf, Uu, Uu, Uh, Xu, Uu, Uu, Uu, Uu^Tf, Uu, Sm, Xu, Xu
Xu, Xu, Xu, Xu, Xoa, Xoa, Xoa, Ur^Pr/o, Rb, Uu, Ur, Uu, Rb, Uu, Ur, Xoa, Xoa, Xu, Uu, Uh, Ss, Wwg, Wwg^Bcx/, Ias, Ias, Uu, Ur, Ur, Wwg^Bcx\, Wwg, Ss, Uu, Xu, Xu, Uh, Ur, Ur, Sm, Uh, Sm, Rb, Uu, Sm, Uh, Xu, Xu
Xu, Xu, Xu, Xu, Uu^Tf, Xoa, Ur, Rb, Uu, Ur, Ur, Uu^Tf, Rb, Uu^Tf, Xoa, Xoa, Xoa, Xu, Uh, Ur, Ur, Uu, Uu, Wwg, Wwg, Wwg, Wwg, Wwg, Wwg, Rb, Uu, Uu^Tf, Xu, Xu, Xu, Uu^Tf, Xu, Uh, Uu^Tf, Sm, Uh, Rb, Uu^Tf, Xu, Xu, Xu
Uu, Xu, Rb, Uu, Rb, Ur, Uu, Ur, Uu^Tf, Uu, Xu, Xu, Xu, Xoa, Xu, Xoa, Xu, Xu, Xu, Uh, Uu^Tf, Uu^Tf, Uu, Ur, Ur, Ss, Ss, Wwg, Ss, Ss, Uh, Xu, Xu, Xu, Xu, Xu, Xu, Xu, Rb, Uu, Rb, Sm, Uh, Xu, Xu, Xu
Uu, Ur, Rb, Rb, Xu, Uu, Xu, Xu, Xu, Xu, Xu, Xu, Xu, Xu, Xu, Xu, Xu, Xu, Xu, Xu, Xu, Xu, Xu, Uh, Uu^Tf, Uu, Uu, Uh, Uu^Tf, Rb, Uu, Ur, Ur, Xu, Uu^Tf, Xu, Uh, Sm, Uu^Tf, Uh, Sm, Uu, Uu, Xu, Xu, Xu
Ur, Ur, Uu^Tf, Xu, Xu, Xu, Xu, Xu, Xu, Xu, Qxu, Xu, Uu^Tf, Xu, Uh, Uh, Uu^Tf, Xu, Xu, Xu, Xu, Xu, Xu, Xu, Uu, Uu, Uu, Ur, Ur, Uu, Uh, Uh, Uu, Uh, Uu, Rb, Rb, Uu, Sm, Uh, Uu, Sm, Uh, Xu, Xu, Xu
Xu, Uu, Xu, Xu, Xu, Xu, Uh, Qxu, Qxu, Qxu, Wog, Qxu, Uu, Uu, Uu^Tf, Uu^Vu, Uu, Uh, Uu^Tf, Xu, Uu^Tf, Xu, Xu, Xu, Uu^Tf, Uh, Ur, Xu, Xu, Uu, Xu, Uu^Tf, Uu, Ur, Uh, Uu, Xu, Uu^Tf, Uh, Uu, Xu, Uu^Tf, Xu, Xu, Xu, Xu
Xu, Xu, Xu, Xu, Xu, Xu, Xu, Qxu, Qxu, Wog, Wog, Wog, Wwg, Ur, Uh, Ur, Ur, Uh, Uu^Tf, Xu, Ur, Uh, Xu, Uh, Uu^Vu, Ur, Uh, Xu, Xu, Xu, Xu, Xu, Ur, Uu^Tf, Uu, Xu, Xu, Xu, Xu, Xu, Xu, Xu, Xu, Xu, Xu, Xu
Wog, Xu, Xu, Xu, Uu, Xu, Xu, Xu, Qxu, Wog, Uu^Tf, Uu, Wwg, Uu^Tf, Uu, Uu, Uh, Uu, Uh, Xu, Xu, Uu, Xu, Uu, Ur, Uu, Xu, Xu, Xu, Xu, Uu^Tf, Ur, Uu, Uu, Ur, Xu, Xu, Xu, Xu, Xu, Xu, Xu, Xu, Xu, Xu, Xu
Wog, Xu, Xu, Xu, Uu^Tf, Uu, Xu, Xu, Uh, Wwg, Wwg, Wwg, Wwg, Uh, Wwg, Uu^Tf, Xu, Ur, Ur, Uu^Tf, Xue, Xu, Xu, Uu^Tf, Uh, Ur, Xue, Xu, Xu, Xu, Uu^Tf, Uu, Uh, Uu, Uu^Tf, Ur, Uu^Vu, Xu, Xu, Xu, Xu, Xu, Xu, Xu, Xu, Xu
Wog, Wog, Xu, Xu, Xu, Xu, Xu, Uh, Rb, Rb, Uu^Tf, Uh, Wog, Wog, Wog, Xu, Xue, Xue, Uue, Uue, Qlf, Xue, Xue, Xue, Rb, Uue, Qlf, Xue, Xu, Xu, Uu, Uu, Uh, Qxu, Qxu, Uu^Tf, Uu, Uu, Uu, Xu, Qxu, Xu, Xu, Xu, Xu, Xu
Wog, Wog, Wog, Xu, Xu, Xu, Xu, Uu^Tf, Uu, Uu, Uu, Wwg, Wog, Wog, Xu, Xu, Xue, Qlf, Uue^Tf, Rb, Uhe, Qlf, Uue, Uue^Tf, Uhe, Uhe, Qlf, Xue, Xu, Xu, Xu, Uu, Uu^Vu, Qxu, Qxu, Qxu, Qxu, Uu^Tf, Ur, Uu, Qxu, Qxu, Qxu, Xu, Xu, Xu
Wog, Wog, Wog, Xu, Xu, Xu, Xu, Xu, Uh, Rb, Uh, Uu^Tf, Xu, Xu, Xu, Xu, Xue, Qlf, Uue, Rb, Uue^Tf, Uhe, Rb, Uue, Qlf, Uue, Xue, Xue, Xu, Xu, Xu, Uu, Ur, Uh, Uh, Qxu, Qxu, Uu^Tf, Uh, Ur, Uu, Qxu, Qxu, Xu, Xu, Xu
Xu, Wog, Wog, Wog, Wog, Xu, Xu, Xu, Xu, Rb, Uu, Xu, Uu, Uu, Xu, Xue, Qlf, Uhe, Uue^Tf, Uue^Vu, Qlf, Uue, Rb, Uue^Tf, Qlf, Qxe, Qxe, Xu, Uu, Xu, Xu, Xu, Qxu, Ur, Uu, Qxu, Qxu, Qxu, Uh, Uu^Vu, Uu, Qxu, Qxu, Xu, Xu, Xu
Xu, Xu, Wog, Wog, Wog, Wog, Xu, Xu, Xu, Uu^Tf, Uh, Xu, Xu, Uu^Tf, Xu, Xue, Qlf, Uue, Uue, Qlf, Uue^Tf, Qlf, Uue, Uhe, Xue, Qxe, Qxu, Qxu, Uh, Uh, Xu, Xu, Qxu, Uu^Tf, Uu^Tf, Uu^Vu, Qxu, Qxu, Qxu, Uu, Uu, Uh, Qxu, Qxu, Xu, Xu
Xu, Xu, Xu, Wwg, Wwg, Wog, Wwg, Xu, Xu, Uu^Tf, Rb, Uu^Vu, Xu, Xu, Xu, Xue, Xue, Qlf, Xue, Uhe, Uhe, Uue, Xue, Xue, Xu, Xu, Qxu, Qxu, Ur, Xu, Xu, Xu, Qxu, Qxu, Uu, Ur, Ur, Qxu, Qxu, Uu, Uu, Uh, Qxu, Qxu, Xu, Xu
Xu, Xu, Ss^Vhs, Ss, Wwg, Wwg, Ss, Xu, Xu, Uh, Uu, Rb, Uh, Xu, Xu, Xu, Xu, Xue, Xu, Xue, Xue, Xue, Xu, Xu, Uu^Tf, Qxu, Qxu^Bcx/, Qxu, Qxu, Xu, Xu, Qxu, Qxu, Qxu, Qxu, Uh, Uu, Uu, Cte, Ur, Ur, Qxu, Qxu, Xu, Xu, Xu
Xu, Xu, Ss, Ss, Wwg, Ss, Ss, Xu, Xu, Xu, Uu^Tf, Uh, Rb, Uu^Tf, Uu, Uu^Tf, Uh, Xu, Qxu, Xu, Xu, Xu, Uh, Uu, Uh, Ias, Ias, Qxu, Xoa, Xoa, Xu, Xu, Xu, Qxu, Qxu, Uh, Uu, Cte, Kte, Cte, Uu, Uu, Xu, Xu, Xu, Xu
Xu, Xu, Uu^Tf, Uu, Ur, Wwg, Uu, Uu^Tf, Xu, Xu, Xu, Uu^Tf, Uh, Rb, Uu, Uh, Rb, Qxu, Qxu^Bp/, Uu, Qxu^Bp\, Qxu, Qxu^Bp/, Rb, Xoa, Uu^Tf, Ias^Pr/o, Ias^Pr/o, Uu^Tf, Xoa, Xu, Xu, Xu, Qxu, Qxu, Qxu, Uu, Cte, Cte, Cte, Ur, Uu, Xu, Xu, Xu, Xu
Xu, Xu, Xu, Uu^Tf, Ss^Vhs, Wwg, Wwg, Uh, Xu, Xu, Uu^Tf, Xu, Xu, Xu, Xu, Uu^Tf, Uh, Rb, Qxu, Qxu, Qxu, Uu, Qxu, Qxu, Xoa, Xoa, Uu^Tf, Uu, Uh, Xu, Xu, Xu, Xu, Xu, Qxu, Qxu, Uu, Uu, Uu^Vu, Ur, Uu, Uu^Vu, Xu, Xu, Xu, Xu
Xu, Xu, Xu, Ss, Ss, Uu, Ss, Ss, Xu, Xu, Uu, Uh, Xu, Xu, Xu, Xu, Xu, Qxu, Xu, Xu, Xu, Qxu, Qxu, Xoa, Qxu, Xoa, Uh, Rb, Uu, Xu, Xu, Xu, Xu, Xu, Xu, Qxu, Xu, Uu, Uu, Uu, Ur, Uu, Uu, Xu, Uu, Xu
Xu, Xu, Xu, Xu, Uu, Ur, Uh, Xu, Xu, Xu, Xu, Xu, Uu^Tf, Xu, Xu, Xu, Xu, Xu, Xu, Xu, Uu^Tf, Qxu, Qxu, Qxu, Qxu, Rb, Rb, Uu, Uu^Tf, Xu, Xu, Xu, Xu, Xu, Xu, Xu, Xu, Xu, Xu, Xu, Xu, Ur, Uu, Ur, Ur, Ur
Xu, Xu, Xu, Xu, Uu^Tf, Ss, Ur, Xu, Uu^Tf, Ss, Ss, Uh, Ss, Uu^Tf, Uh, Xu, Uu^Vu, Uu^Tf, Ss, Uu, Uh, Uh, Qxu^Bcx/, Qxu^Bcx/, Qxu, Qxu, Uu^Tf, Uu^Vu, Uu, Xu, Xu, Xu, Qxu, Qxu, Qxu, Xu, Uu^Tf, Xu, Xu, Xu, Xu, Xu, Xu, Uu, Xu, Uu
Xu, Xu, Xu, Xu, Xu, Uh, Ur, Uh, Uu, Ss, Ur, Uu, Uu, Ss, Ur, Ss, Ss, Uh, Rb, Ss, Uu, Rb, Uu, Qxu, Xu, Xu, Xu, Uh, Rb, Xu, Xu, Xu, Qxu, Ias^Ii, Qxu^Bs\, Uu^Tf, Uh, Uh, Xu, Xu, Xu, Xu, Xu, Xu, Xu, Xu
Xu, Xu, Uh, Xu, Xu, Xu, Uu, Ss, Xu, Xu, Xu, Ur, Uh, Uu^Tf, Ur, Ss, Xu, Xu, Xu, Rb, Xu, Uu^Tf, Uu, Uh, Wwg, Xu, Ss, Ss, Uh, Uu^Tf, Xu, Xu, Xu, Qxu, Uu, Uu, Rb, Uu, Xu, Xu, Xu, Xu, Xu, Xu, Xu, Xu
Xu, Xu, Uu, Uu^Tf, Xu, Xu, Uh, Ss, Xu, Uu^Tfi, Ur, Xu, Uu, Uh, Uu, Xu, Xu, Xu, Xu, Xu, Xu, Xu, Rb, Ss, Ss, Wwg, Rb, Wwg, Wwg, Wwg, Ss, Xu, Xu, Uu^Tf, Uh, Rb, Uh, Uu, Uu^Tf, Xu, Xu, Xu, Xu, Xu, Xu, Xu
Xu, Xu, Xu, Xu, Ur, Uu^Tf, Ss, Uu, Xu, Uh, Xu, Xu, Ss, Wwf, Wwf, Xu, Uu^Tf, Xu, Xu, Xu, Uh, Xu, Xu, Uu, Xu, Uu^Tf, Ss, Ss, Wwg, Ss^Vhs, Uh, Xu, Xu, Uh, Rb, Uu, Uu^Tf, Rb, Uh, Xu, Xu, Xu, Xu, Xu, Xu, Xu
Xu, Xu, Xu, Xu, Ur, Ss, Uh, Uh^Tf, Xu, Xu, Rb, Uu, Uu^Tf, Ss, Uu, Uh, Ss, Sm, Xu, Xu, Uu^Tf, Uu, Xu, Xu, Xu, Xu, Xu, Xu, Xu, Uu^Tf, Xu, Xu, Xu, Xu, Xu, Uu, Rb, Uh, Uu, Xu, Xu, Xu, Xu, Xu, Xu, Xu
Qxu, Xu, Qxu, Qxu, Qxu^Bh|, Qxu, Qxu, Xu, Xu, Uu^Tf, Uh, Ss, Ss, Sm, Wwf, Ss, Uu, Sm^Vhs, Xu, Xu, Xu, Xu, Xu, Xu, Uu^Tf, Xu, Xu, Xu, Xu, Xu, Xu, Xu, Uh^Tf, Xu, Uu, Uh, Uu, Uu^Tf, Uu, Uu^Tf, Xu, Xu, Xu, Xu, Xu, Xu
Qxu, Qxu, Qxu, Qxu, Qxu^Bh|, Qxu, Qxu, Qxu, Qxu, Ss^Vhs, Ss, Uh, Uh, Sm, Xu, Wwf, Xu, Xu, Xu, Xu, Xu, Xu, Uh, Uh, Ur, Uh, Uu, Uh, Uu^Tf, Xu, Xu, Uh^Vu, Uu^Tf, Uh, Ur, Uu, Xu, Rb, Rb, Uu^Tf, Uh, Xu, Xu, Xu, Xu, Xu
Qxu, Qxu, Xu, Qxu, Uu, Qxu, Qxu, Qxu, Xu, Qxu, Xu, Xu, Xu, Xu, Xu, Xu, Xu, Xu, Uu^Tf, Uu, Uu^Tf, Uu, Rb, Uu, Uh, Ur, Uh, Uu, Ur, Uh, Uh, Ur, Rb, Ur, Uu^Tf, Xu, Xu, Uh, Uu, Uu^Vu, Uh, Xu, Xu, Xu, Xu, Xu
Xu, Xu, Xu, Uh, Ur, Uu^Tf, Uh, Qxu, Xu, Xu, Xu, Xu, Xu, Xu, Xu, Xu, Uu, Uu, Uh, Ur, Uh, Uu, Xu, Uu, Rb, Uu^Tf, Xu, Uu^Tf, Xu, Ur, Uu, Ur, Uu^Tf, Uu, Xu, Xu, Xu, Xu, Xu, Uu^Tf, Xu, Xu, Xu, Xu, Xu, Xu
Xu, Xu, Xu, Xu, Uh, Ur, Uu^Tf, Xu, Xu, Xu, Xu, Xu, Uu, Xu, Uu^Tf, Uh, Rb, Uh, Uu^Tf, Ur, Xu, Xu, Xue, Xue, Uue, Uue, Xue, Xu, Xu, Xu, Xu, Uh, Uu, Uh, Xu, Xu, Xu, Xu, Xu, Xu, Xu, Xu, Xu, Xu, Xu, Xu
Xu, Xu, Xu, Xu, Uu^Tf, Uu^Vu, Uu, Rb, Uh, Uu^Tf, Uu, Uh, Rb, Uh, Uh, Rb, Xu, Xu, Xu, Xu, Xu, Xu, Xue, Qlf, Qlf, Rb, Uue^Tf, Xue, Xue, Xu, Xu, Uu^Tf, Rb, Rb, Uu, Xu, Uu^Tf, Xu, Xu, Xu, Ur, Uu^Tf, Xu, Xu, Xu, Xu
Xu, Xu, Ur, Xu, Xu, Uh, Uu, Rb, Uu, Uh, Ur, Uu^Tf, Uu, Rb, Uu^Tf, Xu, Xu, Xu, Xue, Xu, Xue, Xue, Uue, Uhe, Rb, Uue, Uue, Uhe, Xue, Xu, Xu, Xu, Xu, Uu, Uh, Ur, Ur, Uu^Tf, Uh, Xu, Xu, Uh, Xu, Xu, Xu, Xu
Xu, Xu, Uu, Xu, Xu, Xu, Xu, Uu^Tf, Xu, Uu, Uh, Ur, Uh, Uu, Xu, Xu, Xue, Xue, Qlf, Xue, Qlf, Qlf, Uue^Tf, Rb, Uhe, Uue^Tf, Qlf, Uue^Tf, Qlf, Xue, Xue, Xu, Xu, Xu, Xu, Uh, Uu^Tf, Uu, Uu, Uh, Xu, Xu, Mm^Xm, Mm^Xm, Mm^Xm, Xu
Xu, Xu, Xu, Xu, Uh, Xu, Xu, Xu, Xu, Xu, Xu, Xu, Xu, Xu, Xu, Xu, Xue, Qlf, Uue^Tf, Uhe^Vu, Uhe, Uue, Rb, Uhe, Qlf, Uue, Qlf, Rb, Uue^Vu, Qlf, Xue, Xu, Xu, Xu, Xu, Uu, Ur, Ur, Ur, Uh, Hhd, Xu, Mm^Xm, Mm^Xm, Mm^Xm, Mm^Xm
Xu, Xu, Xu, Uu, Xu, Ur, Uu^Tf, Xu, Xu, Xu, Xu, Uu, Uu^Tf, Xu, Xu, Xu, Xue, Qlf, Uue, Rb^Ii, Qlf, Rb, Xue, Uue^Tf, Qlf, Uue, Uhe, Rb, Uue^Tf, Qlf, Xue, Xu, Uu^Tf, Uu, Xu, Uh, Uh, Uu, Hhd, Hh, Hhd, Md^Xm, Mm, Mm, Mm, Mm
Xu, Xu, Xu, Uu^Tf, Uh, Uu^Ii, Xu, Xu, Xu, Xu, Xu, Uh, Xu, Xu, Xu, Xu, Xu, Xue, Xue, Xue, Xue, Xue, Xu, Xue, Xue, Qlf, Xue, Uhe, Xue, Xue, Xu, Xu, Xu, Uh, Xu, Xu, Hhd, Hh^Dr, Mm, Mm, Hhd^Ecf, Gll, Hhd, Md^Xm, Hh, Gll^Fp
Xu, Xu, Xu, Xu, Uu, Uu^Tf, Xu, Xu, Xu, Xu, Xu, Xu, Xu, Xu, Xu, Xu, Xu, Xu, Xu, Xu, Xu, Xu, Xu, Xu, Xu, Xue, Xu, Xue, Xu, Xu, Xu, Xu, Xu, Xu, Mm^Xm, Xu, Md^Xm, Hh, Gll, Mm, Mm, Rb, 1 Gll^Dr, Hh, Gs^Fms, Gll^Fp
Xu, Xu, Xu, Xu, Xu, Xu, Xu, Xu, Xu, Xu, Xu, Xu, Xu, Xu, Xu, Xu, Xu, Xu, Xu, Xu, Xu, Xu, Xu, Xu, Xu, Xu, Xu, Xu, Xu, Xu, Xu, Xu, Xu, Mm^Xm, Mm^Xm, Mm^Xm, Mm, Mm, Gs^Fms, Hh, Gll^Fp, Rb, Gll, Gll, Hhd, Hh
Xu, Xu, Xu, Xu, Xu, Xu, Xu, Xu, Xu, Xu, Xu, Xu, Xu, Xu, Xu, Xu, Xu, Xu, Xu, Xu, Xu, Xu, Xu, Xu, Xu, Xu, Xu, Xu, Xu, Xu, Xu, Xu, Xu, Mm^Xm, Mm^Xm, Mm, Mm, Mm, Gg, Gll^Fp, Hh, Hh, Gg, Hh, Hhd, Hh
