Xu, Xu, Xu, Xu, Xu, Xu, Xu, Md^Xm, Md^Xm, Md, Md, Md, Gll^Fdw, Gll^Fdw, Rb, Gll^Fmw, Gll^Fmw, Wwg, Wwg, Gll^Fdw, Gll^Fdw, Ss, Ss, Gll^Fdw, Gll^Fdw, Gd, Gd, Gd, Gll^Fdw, Gll^Fdw, Gd, Gd, Gd, Gd, Gll^Fmw, Gll^Fmw, Gll^Fmw, Gd, Gd, Gd, Re, Gd, Gll^Fmw, Gll^Fmw, Gll^Fmw, Gll^Fmw
Xu, Xu, Xu, Xu, Xu, Xu, Xu, Xu, Md^Xm, Md, Hhd, Md, Ss, Rb, Gll^Fdw, Ss, Wwg, Wwg, Ss, Ss, Rb, Ss, Rb, Rb, Gll^Fmw, Gd, Gll^Fdw, Gd, Gll^Fmw, Gll^Fmw, Gd, Gd, Gd, Gd, Gd, Gll^Fmw, Gd, Gd, Re, Re, Ket^Vct, Re, Re, Gll^Fmw, Gll^Fmw, Gll^Fmw
Xu, Xu, Re^Emf, Re^Emf, Xu, Xu, Xu, Xu, Md^Xm, Hhd, Md, Hhd, Ss, Gll^Fdw, Gll^Vc, Gll^Fdw, Ss, Chs, 7 Khs, Chs, Rb, Ss, Gll^Fmw, Ss, Gd^Vc, Gd, Gll^Fmw, Gll^Vc, Gd^Fetd, Gll^Fdw, Gd, Gd, Md, Gd, Hhd, Gd, Gd, Re, Ket^Vct, Ket, Cfr, Ket, Ket^Vct, Re, Gd, Gd
Xu, Xu, Re^Emf, Re^Emf, Uu, Uu^Vud, Uu^Tf, Cud, Hhd, Md, Md, Md, Md, Ss, Hhd, Gll^Fmw, Ss, Chs, Chs, Chs, Ss, Gll^Fdw, Gll^Fdw, Ss, Gd, Gd, Gd, Gll^Fdw, Hhd^Fdw, Hhd, Md, Md, Md, Md, Md, Hhd, Gd, Re, Ket, Cfr, 5 Kfr, Ce^Ebn, Ket, Re, Gd, Gd
Xu, Xu, Uu, Uu^Ebn, Ur, Ur, Uh, Cud, Cud, Hhd, Md^Xm, Md, Md, Md, Md, Hhd, Wwg, Wwg, Gll^Fdw, Gll^Vc, Gll^Fdw, Ss, Gd, Gd, Gll^Fmw, Gd, Md, Md, Md, Md, Md, Md, Md, Md, Md, Md, Hhd, Re, Ket^Vct, Ce^Ebn, Cfr, Cfr, Ket^Vct, Re, Gd, Gd
Xu, Xu, Uh, Uu^Vud, Xu, Xu, Xu, Xu, Xu, Md^Xm, Xu, Md^Xm, Md^Xm, Md, Md, Md, Wwg, Wwg, Wwg, Gll^Fmw, Wwg, Gd, Gd^Vc, Gll^Fmw, Gll^Fmw, Gd, Hhd, Md, Md, Md, Md, Hhd, Hhd, Md, Md, Hhd, Hhd, Re, Re, Ket, Ket^Vct, Ket, Re, Re, Hhd, Hhd
Xu, Xu, Uu^Tf, Ur, Re^Emf, Re^Emf, Re^Emf, Xu, Xu, Xu, Xu, Xu, Md^Xm, Md, Md, Hhd, Hhd, Wwg, Wwg, Wwg, Wwg, Wwg, Wwg, Gll^Fmw, Gll^Fmw, Gd, Md, Hhd, Hhd, Md, Md, Md, Md, Hhd, Hhd, Hhd, Gd, Gd, Gd, Re, Re, Re, Gd, Gd, Md, Hhd
Xu, Xu, Xu, Ur, Uu, Re^Emf, Xu, Xu, Xu, Xu, Xu, Xu, Xu, Md^Xm, Hhd, Md, Md, Md, Md, Wwg, Gll^Fmw, Wwg, Wwg, Wwg, Gd, Gd, Gd, Md, Md, Hhd, Gd, Md, Gd, Hhd, Gd, Gd, Gll^Fmw, Gd, Gd, Gd, Gd, Gd, Md, Md, Hhd, Hhd
Xu, Xu, Xu, Xu, Uh^Tf, Uu, Uh, Re^Emf, Re^Emf, Xu, Xu, Xu, Xu, Md^Xm, Md, Md, Hhd, Hhd, Md, Gll^Fmw, Gd^Fetd, Gll^Fmw, Wwg, Wwg, Wwg, Gd, Re, Re^Vct, Re, Gd, Re^Ebn, Gd, Hhd^Fdw, Gd^Fdw, Hhd, Hhd^Fmw, Hhd^Fmw, Gll^Fmw, Gd, Gd, Hhd, Hhd, Md, Md, Md, Hhd
Xu, Xu, Xu, Xu, Xu, Ur^Ebn, Ur, Re^Emf, Re^Emf, Xu, Xu, Xu, Xu, Md^Xm, Md, Md, Md, Hhd, Hhd, Gll^Fdw, Gll^Fdw, Gll^Fmw, Rb, Wwg, Wwg, Re, Re^Vct, Re, Ce, Ce, Ce, Re, Re, Hhd^Fmw, Gd, Hhd, Gd, Gll^Fmw, Gd, Gd, Md, Md, Md, Md, Hhd, Hhd
Xu, Xu, Re^Emf, Re^Emf, Uu, Uu^Vud, Uu, Uu, Xu, Xu, Re^Emf, Xu, Xu, Md^Xm, Md, Md, Md, Md, Md, Gd^Vc, Gd, Rb, Gll^Fdw, Wwg, Wwg, Gd, Re, Re, Ce, 6 Ke, Ce, Re^Vct, Re, Gd, Hhd, Gd, Hhd, Gd, Hhd, Hhd, Md, Md, Md, Md, Md, Hhd
Xu, Xu, Re^Emf, Re^Emf, Uh, Uu^Tf, Ur, Uu^Tf, Xu, Re^Emf, Re^Emf, Xu, Md^Xm, Md^Xm, Md^Xm, Md, Hhd, Md, Md, Gll^Fdw, Rb, Gll^Fdw, Gll^Fmw, Wwg, Wwg, Gd, Gd, Re^Ebn, Re, Ce, Re^Ebn, Re, Gd, Hhd, Md, Md, Md, Hhd, Hhd, Md, Md, Md, Md, Md, Hhd, Hhd
Xu, Xu, Xu, Xu, Re^Emf, Uh, Ur, Uu, Uh, Re^Emf, Xu, Xu, Md^Xm, Md^Xm, Md^Xm, Md, Md, Hhd, Md, Gll^Fdw, Gll^Fmw, Rb, Gd, Wwg, Wwg, Gd, Cfr, Gd, Re^Vct, Re, Gd, Gd, Hhd, Md, Md, Md, Md, Md, Md, Hhd, Md, Md, Md, Md, Md, Hhd
Xu, Xu, Xu, Re^Emf, Re^Emf, Uu, Uu^Vud, Uu, Ur, Uu^Vud, Re^Emf, Xu, Xu, Md^Xm, Md, Md, Md, Hhd, Hhd, Gll^Fdw, Rb, Gd, Gd, Wwg, Wwg^Bw/, Cfr, Cfr, Re, Re, Re, Gd, Gd, Hhd, Md, Md, Md, Md, Md, Hhd, Hhd, Md, Hhd, Hhd, Md, Md, Md
Xu, Xu, Xu, Re^Emf, Xu, Xu, Uu, Ur, Xu, Re^Emf, Re^Emf, Re^Emf, Xu, Md^Xm, Md, Hhd, Hhd, Md, Gll^Fmw, Rb, Gd, Gd, Cfr, Wwg^Bw/, Wwg, Cfr, Cfr, Cfr, Gd, Gll^Fmw, Gll^Fdw, Gll^Fmw, Gll^Fmw, Hhd, Gd, Md, Md, Md, Md, Md, Hhd, Hhd, Md, Md, Md, Md
Xu, Xu, Xu, Xu, Xu, Uu^Tf, Ur, Uu^Ebn, Uu, Xu, Xu, Xu, Md^Xm, Md^Xm, Md, Md, Md, Hhd, Gll^Fdw, Gll^Fdw, Gd, Cfr, Cfr, Wwg, Wwg^Bw/, Wwg^Bw/, Wwg, Gd, Gd, Gll^Fmw, Gd, Gll^Fdw, Gll^Fdw, Gd, Gd, Gd, Re, Hhd, Re, Gd, Gd, Md, Md, Md, Md, Md
Xu, Xu, Re^Emf, Re^Emf, Uu, Ur, Uh, Uh, Cud, Cud, Hhd, Md^Xm, Md, Md, Md, Hhd, Gd, Gd, Gd, Gd, Gd, Gd, Cfr, Cfr, Gd, Wwg, Wwg, Wwg, Wwg, Gd, Hhd, Gd, Gd, Gd, Ce, Ce, Re^Vct, Re, Re, Ce, Ce, Md, Md, Md, Hhd, Hhd
Xu, Xu, Re^Emf, Re^Emf, Ur, Uu^Vud, Xu, Xu, Xu, Hhd, Md, Md, Md, Md, Gd, Gd, Gll^Fdw, Gll^Fmw, Gd, Gll^Fmw, Gll^Fmw, Gd, Gd, Gd, Gd, Gd, Gd, Wwg, Wwg, Hhd, Md, Hhd, Hhd, Gd, Re, Re, Ce, Ce, Ce, Re, Re, Gd, Md, Md, Md, Hhd
Xu, Xu, Xu, Uh, Uh, Ur, Re^Emf, Re^Emf, Xu, Md^Xm, Md, Md, Hhd, Gd, Gd, Gd, Gd, Gll^Fdw, Gd, Gll^Fdw, Gd, Gd, Gll^Fdw, Gd, Gll^Fmw, Gll^Fmw, Gd, Wwg, Wwg, Md, Md, Md, Md, Gd, Ce, Re^Vct, Ce, 4 Ke, Ce, Re^Vct, Ce, Hhd, Hhd, Md, Hhd, Hhd
Xu, Xu, Xu, Uu^Tf, Ur, Uu, Re^Emf, Re^Emf, Xu, Md^Xm, Md, Md, Md, Hhd, Gd, Cfr, Gd, Gd, Gd, Gd, Gd, Gll^Fmw, Gll^Fmw, Gd, Gd, Gll^Fdw, Gd, Wwg, Wwg, Hhd, Hhd^Fmw, Md, Gd, Gd, Ce, Re, Re, Ce, Re, Re, Ce, Hhd^Fmw, Gd, Gd, Hhd, Hhd
Xu, Xu, Xu, Xu, Uu^Ebn, Ur, Xu, Xu, Md^Xm, Md^Xm, Md, Md, Md, Hhd, Gd, Gd, Gd, Cfr, Gd, Gd, Gd, Gd, Gd, Gd, Gd, Gd, Gd, Wwg, Wwg, Hhd^Fmw, Gll^Fdw, Gll^Fdw, Md, Gd, Gd, Ce, Re, Re^Vct, Re, Ce, Gd, Gd, Gll^Fdw, Gll^Fdw, Gd, Hhd
Xu, Xu, Xu, Xu, Ur, Uu^Tf, Xu, Xu, Md^Xm, Md^Xm, Md, Md, Md, Md, Gd, Gd^Vc, Gd, Gd, Hhd, Hhd, Hhd, Gd, Md, Gd, Hhd, Gd, Md, Wwg, Wwg, Wwg, Wwg, Md, Md, Md, Wwg, Gd, Gd, Re, Gd, Gd, Gll^Fdw, Gd, Hhd, Gll^Fmw, Gll^Fmw, Gd
Xu, Xu, Uu^Tf, Ur, Uh, Uh, Xu, Md^Xm, Md^Xm, Md, Md, Md, Hhd, Hhd, Gd, Cfr, Gd, Gd, Md, Md, Md, Md, Md, Md, Md, Md, Md, Md, Hhd, Wwg, Wwg, Wwg, Wwg, Wwg, Wwg, Wwg, Wwg, Gd, Gd, Gd, Gll^Fmw, Hhd^Fmw, Hhd, Gll^Fmw, Gd, Gd
Xu, Xu, Uu, Uu, Xu, Xu, Cud, Xu, Md^Xm, Md, Hhd, Gd^Vc, Gd, Rr, Rr, Rr, Gd^Vc, Hhd, Hhd, Md, Md, Md, Md, Md, Md, Md, Md, Hhd, Hhd, Gd, Gd, Wwg, Wwg, Wwg, Gd, Wwg, Wwg, Wwg, Wwg, Gd, Gd, Gd, Re, Gd, Gd, Gd
Xu, Xu, Uh, Ur, Xu, Cud, 2 Kud, Cud, Hhd, Hhd, Hhd, Gd, Cfr, Gd, Rr, Gd, Gll^Fdw, Hhd, Hhd, Md, Md, Md, Md, Md, Md, Md, Md, Md, Gd, Gd, Gll^Fmw, Gd, Gd, Gd, Gll^Fmw, Gd, Gd, Wwg, Wwg, Gd, Gd, Re, Re, Re, Gd, Gd
Uu, Uh, Uu^Ebn, Ur, Uu, Cud, Cud, Cud, Rr, Cfr, Rr, Rr, Rr, Rr, Gd, Gd, Gll^Fmw, Gll^Fmw, Gd, Hhd, Gd, Md, Hhd, Md, Hhd^Fdw, Hhd^Fdw, Hhd^Fmw, Gd, Gd, Gll^Fdw, Gll^Fmw, Gll^Fdw, Gd, Gd, Gll^Fdw, Gll^Fdw, Gd, Wwg, Wwg, Wwg, Wwg, Cfr, Cfr, Cfr, Wwg, Gd
Rr, Uu, Uu^Tf, Uu, Rr, Rr, Rr, Rr, Rr, Rr, Md, Hhd, Hhd, Gd^Vc, Gd, Cfr, Gll^Fdw, Gll^Fdw, Gd, Gd, Cfr, Gd, Gd, Gd, Gd, Gll^Fdw, Gd, Gd, Gd, Gll^Fdw, Gd, Gd, Md, Gd, Gd, Gd, Gd, Gll^Fdw, Gll^Fdw, Wwg, Wwg, Wwg^Bw|r, Wwg, Wwg^Bw|r, Wwg, Wwg
Uu, Rr, Uu, Rr, Uu, Rr, Cud, Cud, Xu, Md^Xm, Md^Xm, Md, Md, Md, Hhd, Gd, Gd, Gd, Cfr, Hhd, Hhd, Gd, Gd, Gd, Gll^Fmw, Gd, Gll^Fdw, Gd, Gd, Gd, Hhd, Md, Md, Md, Md, Hhd, Hhd, Gll^Fmw, Gd, Gd, Gd, Wwg^Bw|r, Wwg, Wwg^Bw|r, Gd, Wwg
Xu, Uu^Tf, Uh, Uu, Uu, Xu, Uu^Ebn, Uu, Xu, Xu, Md^Xm, Md, Md, Md, Md, Hhd, Md, Gd, Gd, Hhd, Gd, Gd, Gd, Gll^Fdw, Gll^Fdw, Gll^Fmw, Gd, Gd, Md, Md, Md, Hhd, Md, Md, Md, Md, Hhd, Hhd, Gd, Gd, Gd, Cfr, Re, Cfr, Gd, Gd
Xu, Xu, Xu, Uh, Cud, Xu, Uu^Vud, Uu^Vud, Xu, Xu, Xu, Md^Xm, Md^Xm, Md^Xm, Md, Md, Md, Hhd, Hhd, Gd, Gd, Gd, Gd, Gd, Re, Gd, Gd, Gd, Hhd, Md, Hhd, Md, Md, Md, Md, Md, Md, Hhd, Gd, Ce, Gd, Re, Re^Vct, Re, Gd, Gd
Xu, Xu, Xu, Cud, Uu, Xu, Xu, Xu, Re^Emf, Xu, Xu, Xu, Xu, Md^Xm, Hhd, Md, Md, Md, Md, Gd, Gd, Gd, Re, Re, Re^Vct, Re, Re, Gd, Md, Md, Md, Hhd, Hhd, Md, Md, Md, Hhd, Md, Gd, Re, Cfr, Cfr, Ce, Re, Gd, Gd
Xu, Xu, Xu, Uu, Uu^Vud, Ur, Ur, Re^Emf, Re^Emf, Re^Emf, Xu, Xu, Xu, Xu, Ur, Hhd, Xu, Md, Md, Md^Xm, Md, Gd, Re, Re^Vct, Ce, Re^Vct, Re, Gd, Gd, Md, Gd, Gd, Gd, Hhd, Gd, Gd, Gd, Gd, Re, Re, Cfr, Ce, 3 Ket, Re, Re, Gd
Xu, Xu, Xu, Xu, Uh, Uh, Ur, Uu^Vud, Uu, Xu, Re^Emf, Xu, Xu, Xu, Ur, Uu, Xu, Md^Xm, Md^Xm, Md, Hhd, Hhd, Gd, Cfr, Ce^Vht, Ce, Re^Vct, Re, Re, Gd, Gll^Fdw, Gll^Fdw, Gll^Fdw, Gd, Gll^Fdw, Hhd, Gd, Ce, Re, Re^Vct, Cfr, Ce, Ce, Re^Vct, Re, Gd
Xu, Xu, Xu, Xu, Ur, Uu, Uu^Ebn, Uu, Re^Emf, Re^Emf, Re^Emf, Xu, Uu, Uu^Tf, Uh, Uu, Xu, Md^Xm, Md^Xm, Md, Md, Hhd, Gd, Cfr, Cfr, 8 Ke, Re^Vct, Re^Vct, Re, Gd, Gd, Hhd, Hhd, Gd, Gll^Fmw, Gd, Hhd, Gd, Re, Re, Re, Cfr, Re^Vct, Re, Gd, Gd
Xu, Xu, Xu, Uh, Ur, Uu^Vud, Uu, Xu, Xu, Re^Emf, Xu, Xu, Uu, Ur, Xu, Xu, Xu, Xu, Md^Xm, Md, Md, Md^Xm, Md^Xm, Gd, Gd, Re, Re, Re, Gd, Gd, Gll^Fdw, Hhd^Fdw, Gll^Fmw, Gd, Gll^Fdw, Hhd^Fmw, Hhd, Gll^Fmw, Gd, Ce, Gd, Re, Re, Re, Gd, Gd
Xu, Xu, Re^Emf, Re^Emf, Re^Emf, Ur, Re^Emf, Re^Emf, Xu, Xu, Xu, Uh, Uu^Tf, Ur, Uu, Xu, Xu, Xu, Xu, Md^Xm, Md, Md, Md, Md^Xm, Md, Gd, Gd, Gd, Gd, Gd, Gd, Gll^Fmw, Gd, Gd, Gd, Gll^Fdw, Gd, Gll^Fdw, Gd, Gd, Gd, Gd, Gd, Gd, Gd, Gd
Xu, Xu, Re^Emf, Re^Emf, Xu, Xu, Re^Emf, Re^Emf, Xu, Xu, Uu^Tf, Uu, Ur, Uu, Uu^Tf, Xu, Xu, Xu, Xu, Md^Xm, Md^Xm, Md, Md^Xm, Md, Md, Hhd, Md, Md^Xm, Md, Gd, Md, Gd, Hhd, Hhd, Md^Xm, Gd, Gd, Gd, Hhd, Hhd, Md, Md^Xm, Md^Xm, Gd, Hhd, Gd
Xu, Xu, Xu, Re^Emf, Xu, Xu, Xu, Xu, Xu, Xu, Uh, Uu^Vu, 1 Uu, Ur, Xoa, Xu, Xu, Xu, Xu, Md^Xm, Md^Xm, Md, Md, Md^Xm, Md^Xm, Md, Md, Md, Md, Md^Xm, Md^Xm, Md, Md, Md, Md, Md^Xm, Md^Xm, Md, Md, Hhd, Hhd, Md, Md, Md^Xm, Md, Hhd
Xu, Xu, Xu, Xu, Xu, Xu, Xu, Xu, Xu, Xu, Xu, Uh, Ias^Pw/, Ias^Pw/, Xoa, Xu, Xu, Xu, Xu, Xu, Md^Xm, Md, Md, Md, Md, Md, Md, Md, Md^Xm, Md, Md, Md^Xm, Md, Hhd, Hhd, Md, Md, Md, Hhd, Hhd, Md, Md^Xm, Md^Xm, Md, Md, Md
Xu, Xu, Xu, Xu, Xu, Xu, Xu, Xu, Xu, Xu, Xu, Xoa, Uu, Ias, Xoa, Xu, Xu, Xu, Xu, Xu, Md^Xm, Md^Xm, Md, Md, Md, Md, Md, Md, Md, Md^Xm, Md^Xm, Md, Hhd, Md, Md, Hhd, Hhd, Hhd, Md^Xm, Md, Md, Md, Md, Md^Xm, Md, Md
Xu, Xu, Xu, Xu, Xu, Xu, Xu, Xu, Xu, Xu, Xu, Xoa, Uu, Uu, Xoa, Xu, Xu, Xu, Xu, Xu, Md^Xm, Md^Xm, Md^Xm, Md, Md, Hhd, Md, Md, Md, Md, Md, Md, Md, Hhd, Md, Md, Md, Md, Md, Md, Md, Md, Md, Md, Md, Md
