Aa, Ms, Ms, Ms^Xm, Ms, Ms, Ha, Aa, Aa, Gd, Ha, Ms, Ms, Ms, Ha, Ha, Ha, Ms, Ms, Ms, Ha, Ms, Ha, Ms, Ms, Ms, Ms^Xm, Ms, Ms, Aa, Gd, Gd, Ms, Ms, Ms, Ms, Ms, Ms^Xm, Ms, Ms, Ms, Ms, Ha, Aa^Fpa, Aa, Aa
Aa, Aa, Ha, Ms, Ms, Ms, Ms^Xm, Ha, Aa^Fpa, Aa^Vca, Ha, Ms, Ha, Ms, Ms, Ha, Ms, Ms^Xm, Ms, Ha, Ms, Ms^Xm, Ms, Ha, Ms, Ms^Xm, Ms^Xm, Ms^Xm, Gd, Gd, Gd, Ha, Ha, Ms, Ha, Ms, Ms^Xm, Ms, Ha, Ha, Ms, Ms, Ha, Gd, Ha^Fpa, Gd
Ha, Aa, Aa^Feta, Ha, Aa^Fma, Ms, Ms, Ms, Ha^Fma, Aa^Fma, Aa, Ms, Ms^Xm, Ha, Ms, Ms^Xm, Ms, Ms, Ms, Ms^Xm, Ms, Ms, Ha, Ms, Cea, Cea, Cea, Aa^Fpa, Aa^Vca, Aa, Aa, Ha, Ms, Ha, Ha, Ms, Ms, Ms, Ms, Ms^Xm, Ms, Ha, Cea, Aa^Vca, Gd, Aa
Ms, Ha, Aa, Aa, Aa, Ms, Ha, Ms, Ha, Aa^Fpa, Aa, Ms, Ms, Ms, Ha, Ms, Ms^Xm, Ha, Ha, Ms, Ms, Ha, Ms^Xm, Ms, Cea, Kea, Cea, Aa, Aa, Aa^Fma, Ms, Ms, Ms, Ms^Xm, Ms, Ms, Ms, Ms^Xm, Ms, Ms, Ms, Cea, Kea, Cea, Gd, Gd
Ms, Ms, Ha, Ha^Fpa, Aa, Ha, Ms, Ms^Xm, Ms, Aa, Aa^Fpa, Ha, Ms, Ms^Xm, Ms, Ms, Ms, Ms, Ms, Ms, Ms^Xm, Ms, Ms, Ms, Gd, Cea, Aa^Fpa, Aa, Aa^Feta, Aa, Ha, Ha, Ms, Ms, Ha, Ha, Ms^Xm, Ms, Ha, Ms, Aa^Fma, Cea, Cea, Cea, Ms^Xm, Aa
Ms^Xm, Ms, Ms, Ha, Aa^Vca, Aa, Aa^Fpa, Ms, Aa^Fma, Aa, Aa, Aa, Ha, Ms, Ms, Ms^Xm, Ms, Ms, Ms^Xm, Ms, Ms, Ms, Ms, Ms, Gd, Aa, Aa, Aa, Aa, Aa, Ms, Ms^Xm, Ms, Ms, Ms, Ms^Xm, Ms^Xm, Ms, Ha, Gd, Aa^Vca, Aa^Fpa, Aa, Ms, Ms, Ms
Ms^Xm, Ms, Ms, Ha, Aa, Aa, Gd, Aa^Fpa, Aa, Aa, Ha, Gd, Ha^Fpa, Ha, Aa, Ms, Ha, Ms, Ms, Ms, Ha, Ha, Ha^Fpa, Gd, Gd, Gd, Aa^Fpa, Aa^Fpa, Gd, Gd, Ha^Fpa, Ms, Aa^Fma, Ha, Ha, Ms, Ms, Ha, Gd, Gd, Aa^Fpa, Aa, Ha, Ha, Ms, Ms
Ms^Xm, Ms^Xm, Ms, Ha, Gd, Aa^Fpa, Aa, Aa, Ms, Ha, Ms^Xm, Ms, Ha, Aa, Gd, Gd, Aa, Ha^Fpa, Gd, Gd, Aa^Fpa, Gd, Gd, Aa, Gd, Gd, Ms^Xm, Aa^Fpa, Ha, Aa^Fpa, Aa, Aa, Aa, Aa, Ha, Ms, Gd, Aa, Aa^Fpa, Gd, Aa^Fma, Ms, Ms, Ms, Ms^Xm, Ms^Xm
Ms^Xm, Ms^Xm, Ms, Ms, Ha, Gd, Aa^Fma, Aa, Ms, Ms, Ms, Ms, Ms, Ms^Xm, Ms, Aa, Gd, Gd, Gd, Gd, Aa, Aa, Aa, Aa^Fpa, Aa, Ms, Ms, Ms, Ms, Ha, Ms, Aa^Vca, Aa, Ha^Fpa, Gd, Ha, Aa^Fpa, Ha^Fma, Ms, Ha, Ha, Ha, Ms, Ms, Ms^Xm, Ms^Xm
Ms^Xm, Ms^Xm, Ms, Ms, Ms, Ha, Ms^Xm, Aa^Fpa, Aa^Fma, Ha, Ha, Ms, Ms, Ms, Ms^Xm, Ha, Aa, Aa, Aa, Gd, Ms^Xm, Gd, Ha, Gd, Ha, Ms, Ha, Ha, Ms, Ha, Ms, Aa^Fpa, Gd, Gd, Gd, Gd, Aa, Ms, Ms, Ms, Ms, Ms, Ms^Xm, Ms^Xm, Ms^Xm, Ms^Xm
Ms^Xm, Ms^Xm, Ms^Xm, Ms^Xm, Ms, Ms, Ms, Ms, Ha, Aa, Aa, Aa, Ha, Ms, Ms, Ms, Aa, Aa, Ha, Ms, Ms, Ms, Ms, Ha, Ms, Ha, Ms, Ms^Xm, Ms, Ms, Ms^Xm, Aa^Fpa, Gd, Aa^Fma, Aa, Aa, Ms, Ms^Xm, Ms, Ha, Ms, Ms^Xm, Ms^Xm, Ms^Xm, Ms^Xm, Ms^Xm
Ms^Xm, Ms^Xm, Ms^Xm, Ms, Ms, Ms, Ms, Ms^Xm, Ms, Gd, Gd, Aa^Fma, Aa, Ms, Ha, Ha, Gd, Gd, Ha, Ms, Ms, Ha, Ha, Ms^Xm, Ms^Xm, Ms, Ms, Ms, Ms, Ms, Ms, Ms, Aa, Gd, Gd, Aa, Ha, Ms, Ms, Ms^Xm, Ms, Ms, Ms^Xm, Ms^Xm, Ms^Xm, Ms^Xm
Ms^Xm, Ms^Xm, Ms^Xm, Ms^Xm, Ms^Xm, Ms, Ms^Xm, Ms, Ms, Ha, Ha, Gd, Cfa, Cfa, Cfa, Aa^Fma, Gd, Gd, Ms, Ms^Xm, Ms, Ha, Ms, Ms^Xm, Ms, Ha, Ms, Ha, Ha, Ha, Ha, Ms, Aa, Aa, Aa^Fpa, Aa^Fpa, Ha, Ha, Ms^Xm, Ms, Ms, Ms^Xm, Ms^Xm, Ms^Xm, Ms^Xm, Ms^Xm
Xu, Ms^Xm, Ms^Xm, Ms^Xm, Ms^Xm, Ms^Xm, Xu, Ms^Xm, Ms^Xm, Ms, Ha, Aa, Cfa, Kfa, Cfa, Gd, Aa, Aa^Vca, Ha^Fpa, Ms, Ms, Ms, Ms, Ms, Ms, Ms^Xm, Ms, Ms, Ms, Ms^Xm, Ms, Ms, Ha^Fma, Gd, Aa, Aa, Gd, Ms, Ms, Ms, Ms, Ms, Ms^Xm, Ms^Xm, Ms^Xm, Ms^Xm
Xu, Xu, Xu, Xu, Xu, Xu, Xu, Xu, Xu, Ms^Xm, Ms^Xm, Ha, Aa^Vca, Cfa, Gd, Aa, Aa^Fpa, Aa, Gd, Ha, Ha, Ha, Ms, Ms, Ha, Ms, Ha, Ha, Ms, Ms, Ha, Aa, Aa^Vca, Gd, Aa, Aa^Fpa, Aa^Fma, Aa^Fpa, Ha, Ha, Ms, Ms, Ms^Xm, Ms^Xm, Ms^Xm, Ms^Xm
Xu, Xu, Xu, Xu, Xu, Xu, Uu, Xu, Xu, Ms^Xm, Ha, Aa, Aa, Aa^Fpa, Aa, Gd, Gd, Aa^Fpa, Gd, Aa^Fpa, Aa, Aa, Aa, Ha, Ha^Fpa, Aa, Gd, Ms, Ha^Fpa, Ha, Aa^Fpa, Aa^Feta, Aa, Ha^Fpa, Gd, Aa, Aa, Gd, Ha, Ms, Ha, Ha, Ms^Xm, Ms^Xm, Ms^Xm, Ms^Xm
Uu, Xu, Uh, Uh, Uu, Uu^Tf, Uh, Uu, Ha, Ha, Ms, Ms^Xm, Aa^Fpa, Gd, Gd, Gd, Ai, Ai, Ai, Aa, Ai, Aa^Fpa, Aa, Gd, Aa, Gd, Ha^Fpa, Gd, Gd, Aa, Ha^Fma, Aa, Aa^Fpa, Gd, Aa, Aa, Gd, Gd, Ms, Ms^Xm, Ms, Ms, Ms, Ms^Xm, Ms^Xm, Ms^Xm
Ur, Uu, Rb, Rb, Ur, Rb, Rb, Uu, Ha, Ha, Ha, Ms, Ha^Fpa, Gd, Aa, Ai, Wwg, Wog, Ai, Ai, Ai, Ai, Aa^Fpa, Aa, Aa^Vca, Aa, Ms^Xm, Aa, Gd, Aa^Fma, Ha^Fpa, Gd, Gd, Aa, Gd, Aa, Aa^Fpa, Aa^Fpa, Aa, Ms, Ms, Ms^Xm, Ms, Ms^Xm, Ms^Xm, Ms^Xm
Uh, Ur, Uu, Uu, Uh, 1 Ur, Rb, Uh, Ha, Ms, Ms^Xm, Ha, Ai, Aa, Ai, Ai, Wog, Wwg, Wog, Ai, Wog, Ai, Ai, Aa^Fpa, Aa, Ms, Ms, Ms, Ha, Aa, Ha, Aa, Ms^Xm, Gd, Ms, Ha, Ha, Aa^Vca, Aa, Ha, Ha, Ms, Ms, Ms^Xm, Ms, Ms^Xm
Xu, Uh, Uu, Uu^Tf, Uu^Tf, Uu, Xu, Uh, Ha, Ms, Aa, Ai, Ai, Ai, Ai, Wwg, Wog, Ai, Wog, Wog, Wwg, Ai, Ai, Aa^Fma, Gd, Ha, Ms, Ms^Xm, Ms, Ha, Ms, Ms, Ms, Ms, Ms, Ms, Ha, Aa^Fpa, Gd, Aa, Gd, Ha, Ms, Ms, Ms, Ms
Xu, Xu, Xu, Xu, Xu, Xu, Xu, Ms^Xm, Ms, Ha, Aa, Ai, Wog, Wwg, Wog, Ai, Wwg, Ai, Wwg, Wog, Ai, Ai, Aa, Aa, Gd, Gd, Ha, Ms, Ms, Ms^Xm, Ms, Ms, Ms, Ha, Ha, Ms, Ms, Ha, Gd, Gd, Ha^Fpa, Aa^Fma, Aa^Feta, Cea, Cea, Ms
Xu, Xu, Xu, Xu, Xu, Xu, Ms^Xm, Ms^Xm, Ms, Aa^Feta, Aa, Ai, Ai, Wog, Wog, Wwg, Ai, Wog, Ai, Ai, Aa^Fpa, Ai, Gd, Gd, Ms, Ms^Xm, Ms, Ha, Ms^Xm, Ms^Xm, Ha, Ha, Ms, Ha, Ha, Ms, Ha, Ms, Aa, Aa^Fpa, Aa^Fma, Aa, Ha^Fpa, Aa^Fpa, Cea, Aa^Fpa
Ms^Xm, Ms^Xm, Ms^Xm, Xu, Ms^Xm, Ms^Xm, Ms^Xm, Ms, Ha, Aa^Fma, Aa^Fpa, Gd, Gd, Ai, Wwg, Wwg, Ai, Wog, Ai, Aa, Aa^Fpa, Ha^Fpa, Ha^Fpa, Aa, Ha, Ms, Ha, Ms, Ms, Ms, Ha, Ha, Ms^Xm, Ms, Ms^Xm, Ms^Xm, Ms, Ms, Aa, Aa, Aa^Fpa, Aa, Cea, Kea, Cea, Gd
Ms^Xm, Ms^Xm, Ms^Xm, Ms^Xm, Ms^Xm, Ms^Xm, Ms, Ha, Aa^Fpa, Aa^Fpa, Aa, Aa^Fpa, Aa, Ai, Ai, Ai, Aa^Fpa, Ai, Ms, Aa, Gd, Gd, Gd, Aa^Vca, Ms, Ms^Xm, Ms, Ha, Ms, Ms^Xm, Ms, Ms, Ms, Ms, Ms, Ms, Ha, Ha, Aa^Fpa, Gd, Aa, Aa, Aa, Cea, Ms, Gd
Ms^Xm, Ms^Xm, Ms^Xm, Ms^Xm, Ms^Xm, Ms^Xm, Ms, Ms, Aa, Aa^Fpa, Aa^Fpa, Aa, Gd, Aa^Vca, Aa, Ha, Aa, Aa, Ha, Ha, Ms^Xm, Ms, Ms, Ha^Fpa, Aa^Fpa, Ms, Ms, Ms^Xm, Ms, Ms, Ms^Xm, Ha, Ha, Ha, Ms, Ms^Xm, Ms, Ha, Aa, Gd, Aa, Aa^Vca, Aa, Ms, Ms^Xm, Ms
Ms^Xm, Ms^Xm, Ms^Xm, Ms, Ms, Ms^Xm, Ms, Ha, Aa, Gd, Ms, Ms^Xm, Ms, Ha, Ms^Xm, Aa^Fpa, Aa, Ms, Ms^Xm, Ms, Ms, Ms, Ha, Aa, Aa, Aa, Ha, Ms, Ms^Xm, Ms, Ms, Ms, Ha, Ms, Ms^Xm, Ms, Aa^Vca, Aa, Aa^Fpa, Gd, Gd, Aa^Fpa, Ha, Ms, Ms, Ms
Ms^Xm, Ms^Xm, Ms^Xm, Ms^Xm, Ms, Ms, Ms, Ha, Aa, Aa^Fpa, Ha, Ms, Ms^Xm, Ms, Ms, Ms, Aa^Fpa, Ms, Ha, Ha, Aa, Ha, Aa, Gd, Aa, Aa, Aa^Fpa, Ms, Ms, Ms, Ms, Ms, Ms^Xm, Ms, Ms, Ms, Gd, Aa, Aa^Fma, Gd, Ms, Ms^Xm, Ms, Ha, Ms^Xm, Ms
Ms^Xm, Ms^Xm, Ms^Xm, Ms, Ms^Xm, Ha, Ha, Aa, Gd, Aa^Fpa, Ms, Ms, Ms, Ms, Ms, Ha, Gd, Aa, Ha^Fpa, Gd, Aa, Aa^Fma, Gd, Aa^Fpa, Aa, Gd, Gd, Aa, Aa^Fpa, Ha, Ha, Ms, Ms, Ms, Aa, Aa^Fpa, Gd, Aa^Fma, Gd, Aa, Ha, Ms, Ms^Xm, Ms, Ms, Ms
Ms^Xm, Ms^Xm, Ms^Xm, Ms, Ms, Ms, Aa, Aa, Aa, Aa^Fpa, Aa^Vca, Ha, Ha, Ms, Aa, Ha, Gd, Aa, Ha, Aa^Fpa, Ha, Gd, Aa, Gd, Gd, Gd, Ha^Fpa, Aa, Aa^Fma, Aa^Fpa, Gd, Gd, Gd, Aa, Ms^Xm, Aa, Aa, Gd, Ms, Ha, Ms, Ms, Ms, Ms, Ms^Xm, Ms
Ms^Xm, Ms^Xm, Ms^Xm, Ms, Ms, Ms, Ha, Aa^Fpa, Gd, Aa^Fpa, Aa^Fpa, Aa, Gd, Ha^Fpa, Aa^Fma, Aa^Vca, Aa, Aa, Ms^Xm, Ha, Ms, Ms, Ms, Ms^Xm, Ms, Ha, Ha, Gd, Gd, Aa, Aa^Fpa, Aa^Fma, Aa^Vca, Ms, Ms, Ms, Ha^Fpa, Gd, Ms, Ms, Ms, Ms, Ha, Ms, Ms, Ms
Ms^Xm, Ms^Xm, Ms^Xm, Ms, Ms, Ms, Ha, Aa, Aa, Aa^Fpa, Gd, Gd, Cha, Gd, Ms, Ha, Ha, Ms, Ms, Ms, Ms, Ms, Ms^Xm, Ms, Ms, Ha, Ms, Ms, Ms, Aa^Fpa, Aa^Feta, Aa^Fpa, Ha, Ms, Ms, Ha, Cea, Cea, Cea, Ms, Ms, Ms^Xm, Ms, Ha, Ms, Ms
Ms^Xm, Ms^Xm, Ms^Xm, Ms^Xm, Ms, Ms^Xm, Ms, Aa, Aa^Vca, Ha^Fpa, Aa, Cha, 2 Kva, Ms^Xm, Ms^Xm, Ms^Xm, Ms, Ms, Ha, Ha, Ha, Ms, Ms, Ms, Ms, Ms, Ms, Ms, Ms, Ms^Xm, Ms, Aa^Fpa, Ha, Ha, Ms, Ms^Xm, Ms, Cea, Kea, Ha, Ha, Ms, Ms, Ms^Xm, Ms, Ms
Ms^Xm, Ms^Xm, Ms^Xm, Ms^Xm, Ms, Ms, Ha^Fpa, Aa, Aa, Aa, Aa, Cha, Ms^Xm, Ms^Xm, Ms^Xm, Ms^Xm, Ha, Ms, Ms^Xm, Ms^Xm, Ms, Ms, Ha, Ha, Ms, Ms^Xm, Ms, Ha, Ha, Ms, Ms, Aa, Aa, Ha, Ms, Ms, Cea, Cea, Aa^Vca, Aa^Fpa, Ms, Ms^Xm, Ms, Ms, Ha, Ms
Ms^Xm, Ms^Xm, Ms^Xm, Ms, Ha, Ha, Aa, Aa, Aa, Aa^Fpa, Gd, Aa^Fpa, Ms^Xm, Ms^Xm, Ms^Xm, Ms, Ha, Ha, Ms, Ms, Ms^Xm, Ms, Ms, Ms^Xm, Ms, Ms, Ms, Ms^Xm, Ms, Ms, Ms^Xm, Ms, Ms, Gd, Gd, Ha, Aa, Aa, Ha^Fpa, Gd, Aa^Fpa, Ms, Ms, Ms, Ha, Ha
Ms^Xm, Ms^Xm, Ms^Xm, Ms, Gd, Gd, Aa^Fpa, Aa, Aa^Fpa, Gd, Aa, Ms^Xm, Ms^Xm, Ms^Xm, Ms, Ms, Ms, Ms, Ms, Ms, Ms, Ms, Ms, Ms, Ms, Ms, Ms, Ms, Ms, Ms, Ms, Ms, Ms, Gd, Aa^Fpa, Aa, Gd, Aa, Aa^Fpa, Aa, Gd, Ha, Ha, Ms, Ha, Ha
