Md^Xm, Md^Xm, Md^Xm, Md^Xm, Xu, Xu, Xoa, Xoa, Xoa, Xoa, Xoa, Xoa, Xu, Xu, Md^Xm, Md^Xm, Md^Xm, Md^Xm, Md^Xm, Md^Xm, Md^Xm, Md^Xm, Md^Xm, Md^Xm, Md^Xm, Md^Xm, Md^Xm, Md^Xm, Md^Xm, Md^Xm, Md^Xm, Md, Md, Md, Hhd^Fdw, Gll^Fdw, Gll^Fmw, Gll^Fmw, Gll^Fmw, Gll^Fmw, Gll^Fmw
Md^Xm, Md^Xm, Md^Xm, Md^Xm, Xoa, Xoa, Xoa, Xoa, Uu^Vud, Xoa, Xoa, Xoa, Xoa, Xoa, Xoa, Md^Xm, Md^Xm, Md^Xm, Md, Md^Xm, Md, Md^Xm, Md^Xm, Md^Xm, Md^Xm, Md^Xm, Md^Xm, Md^Xm, Md^Xm, Md^Xm, Md^Xm, Md^Xm, Md^Xm, Md, Hhd^Fdw, Gll^Fmw, Gll^Fmw, Gll^Fmw, Gll^Fmw, Gll^Fmw, Gll^Fmw
Md, Md^Xm, Md^Xm, Md^Xm, Xoa, Ias, Xoa, Ias, Ias, Uu, Xoa, Ias, Ias, Cud^Ii, Xoa, Md^Xm, Md^Xm, Md^Xm, Md, Md, Md, Md, Md, Md^Xm, Md^Xm, Md^Xm, Md, Md, Md^Xm, Md^Xm, Md^Xm, Md^Xm, Md, Md^Xm, Md, Gll^Fdw, Gll^Fms, Gll^Fmw, Gll^Fmw, Gll^Fmw, Gll^Fmw
Hhd, Md, Md, Md^Xm, Md^Xm, Xoa, Uu, Ias^Pw\o, Xoa, Ias^Pw/o, Uu, Xoa, Xu, Xoa, Md^Xm, Md^Xm, Hhd, Md, Hhd^Fdw, Hhd^Fdw, Hhd, Hhd^Fdw, Hhd^Fdw, Md, Md^Xm, Md^Xm, Md, Md, Md, Md^Xm, Md, Md^Xm, Md^Xm, Md, Hhd^Fdw, Hhd^Fdw, Gll^Fdw, Gll^Fms, Gll^Fms, Gll^Fmw, Gll^Fmw
Hhd, Hhd, Md, Md^Xm, Xoa, Xoa, Ias, Uu, Xoa, Ias, Uh, Xoa, Md^Xm, Md^Xm, Md^Xm, Hhd^Fdw, Hhd^Fdw, Hhd, Md^Xm, Hhd^Fdw, Md^Xm, Hhd, Hh, Md^Xm, Md^Xm, Md^Xm, Md^Xm, Md, Md, Md, Hhd^Fdw, Md^Xm, Md^Xm, Md, Md, Hhd^Fms, Hh^Fms, Gll^Fdw, Gll^Fms, Gll^Fmw, Gll^Fdw
Md, Md, Md, Hhd, Ias, Uh, Uu, Ias, Uu^Tf, Ias, Uu, Xoa, Md^Xm, Md^Xm, Hhd, Hhd^Fdw, Md, Md^Xm, Md^Xm, Md^Xm, Xu, Hhd^Fdw, Uh, Xu, Xu, Xu, Xu, Md^Xm, Md^Xm, Hhd^Fdw, Md, Md, Md, Md^Xm, Md^Xm, Md, Hh^Fmw, Hhd^Fms, Hhd^Fms, Gll^Fdw, Gll^Fdw
Hhd, Hhd, Md, Hhd, Hhd, Uu, Xoa, Uh, Ias, Uu, Uh, Ias, Hhd, Md, Gll^Fdw, Md, Md, Md^Xm, Md^Xm, Xu, Xu, Uu, Rb, Uu, Uu, Uh, Uu^Tf, Xu, Md^Xm, Gll, Gll^Fdw, Md, Md, Md^Xm, Md^Xm, Md, Md, Hh^Fmw, Gll^Fdw, Gll^Fmw, Gll^Fdw
Gll^Fdw, Hhd^Fdw, Hhd^Fdw, Md, Md, Mm^Xm, Mm^Xm, Xoa, Xoa, Xoa, Mm^Xm, Hhd, Md, Gll^Fdw, Gll^Fdw, Hhd, Md, Md, Md^Xm, Xu, Uu^Tf, Uu, Uu^Tf, Rb, Uu, Rb, Rb, Xu, Hhd, Hhd, Hhd^Fdw, Hhd^Fdw, Md, Md^Xm, Md^Xm, Md^Xm, Md, Gll^Fdw, Gll^Fmw, Gll^Fmw, Gll^Fmw
Gll^Fdw, Gll^Fdw, Md, Md, Md, Md, Md, Mm^Xm, Mm^Xm, Mm^Xm, Md, Md, Hhd^Fdw, Gll, Hhd, Hhd^Fdw, Md, Md^Xm, Md^Xm, Xu, Uh, Rb, Uu, Uh, Rb, Uu^Tf, Uu, Uh, Hhd^Fdw, Gll, Gll^Fdw, Hhd^Fdw, Md, Md, Md^Xm, Md^Xm, Md, Hhd^Fdw, Gll^Fmw, Gll^Fmw, Gll^Fmw
Gll^Fdw, Gll^Fdw, Hhd^Ecf, Hhd, Gll^Fdw, Hhd, Hhd^Fdw, Md, Md, Md, Gll, Hhd, Gll^Fdw, Gll^Fdw, Hhd, Md, Md^Xm, Md^Xm, Md^Xm, Xu, Xu, Rb, Uu^Tf, Uu, Rb, Uu, Xu, Hh, Md, Hhd^Fdw, Md, Md, Md, Md^Xm, Md^Xm, Md^Xm, Hh^Fdw, Hhd^Fdw, Gll^Fdw, Gll^Fmw, Gll^Fdw
Gll, Gll, Ce, Ce, Re^Vct, Gll^Fdw, Gll, Gll^Fdw, Gll^Fdw, Hhd, Hhd^Fdw, Gll, Gll, Gll, Gll^Fdw, Md, Md, Md^Xm, Md^Xm, Md^Xm, Hhd, Uu, Uh, Uh, Uu^Tf, Uh, Xu, Mm^Xm, Mm^Xm, Md, Md, Md, Md^Xm, Md^Xm, Md^Xm, Md^Xm, Md, Hh^Fdw, Hhd^Fms, Gs^Fms, Gll^Fdw
Gll, Gll, Re^Vct, 1 Ke, Ce, Gd^Ecf, Gll, Gll^Fdw, Gll, Hhd, Gll^Fdw, Gll^Fdw, Gll, Gll^Fdw, Hhd^Fdw, Hhd^Fdw, Hhd, Md, Md, Md, Hhd^Fdw, Hhd^Fdw, Xu, Xu, Xu, Xu, Xu, Xu, Xu, Mm^Xm, Hh, Hh, Xu, Xu, Xu, Md^Xm, Md^Xm, Md, Hhd^Fms, Gll^Fmw, Gll^Fdw
Gll^Fdw, Gll^Fdw, Gll^Fdw, Ce, Gll, Gll^Fdw, Hhd^Fdw, Hhd, Hhd, Gll, Md^Xm, Gll, Md, Hhd, Md, Hhd, Md, Hhd^Fdw, Hhd^Fdw, Hhd, Gll, Md, Md^Xm, Md^Xm, Md^Xm, Md^Xm, Xu, Xu, Qxu, Xu, Rb, Uh, Uh, Qxu, Qxu, Md^Xm, Md^Xm, Md, Hhd^Fdw, Gll^Fmw, Gll^Fdw
Md, Gll^Fdw, Hhd, Hhd, Hhd, Hhd^Fdw, Md, Md^Xm, Md, Md, Md, Md^Xm, Md^Xm, Md, Md, Md, Md, Hhd^Fdw, Gll^Fdw, Gll, Gll^Fdw, Md, Md, Md^Xm, Md, Md^Xm, Md^Xm, Xu, Qxu, Qxu, Uh, Rb, Uu, Uu^Tf, Uh, Xu, Md^Xm, Hh^Fdw, Gll^Fdw, Gll^Fdw, Gll^Fdw
Md, Md, Md^Xm, Md^Xm, Md^Xm, Md^Xm, Md^Xm, Md, Hhd^Fdw, Hhd^Fdw, Md, Md, Md, Md, Hhd^Fdw, Md, Hhd^Fdw, Hhd, Gll, Gll, Gll^Fdw, Hhd^Fdw, Hhd, Md, Md, Md^Xm, Xu, Xu, Xu, Uu^Tf, Uu, Uu^Tf, Uh, Uu, Rb, Xu, Gll, Gll^Fdw, Gll, Gll, Gll
Md, Md, Md^Xm, Md^Xm, Xu, Md^Xm, Xu, Hhd, Hhd, Md, Mm^Xm, Md, Md, Hhd, Gll, Gll^Fdw, Gll^Fdw, Gll, Md, Gll, Mm, Md, Mm, Md, Mm, Md^Xm, Md^Xm, Xu, Uh, Rb, Rb, Uu, Uu^Tf, Rb, Uh, Hhd, Gll, Gll, Gll, Gll, Gll
Md^Xm, Md^Xm, Xu, Xu, Uu^Tf, Xu, Uu, Uh, Uu, Xu, Xu, Mm^Xm, Md, Md, Gll^Fdw, Gll, Md, Md, Md^Xm, Md^Xm, Md^Xm, Md^Xm, Md^Xm, Mm, Md^Xm, Md^Xm, Mm, Hh^Fdw, Hhd, Uu, Uu^Tf, Uh, Qxu, Xu, Mm^Xm, Hhd, Hh^Fdw, Gll, Gll, Gll, Gll
Md^Xm, Md^Xm, Xu, Uh, Uu, Uh, Uu, Rb, Uu, Xu, Uh, Hh, Hhd, Gll^Fdw, Gll^Fdw, Md, Md^Xm, Md^Xm, Xu, Xu, Xu, Xu, Xu, Md^Xm, Xu, Md^Xm, Gll, Hhd, Mm, Xu, Xu, Qxu, Xu, Xu, Mm^Xm, Mm^Xm, Hhd^Fdw, Gll^Fdw, Gll^Fms, Gll^Fmw, Gll^Fmw
Hh, Md^Xm, Rb, Rb, Uh, Rb, Ur, Rb, Ur, Uu^Tf, Uu, Hhd, Md^Xm, Hhd^Fdw, Hhd^Fdw, Gll, Hhd, Xu, Uh, Uu^Tf, Uu, Uh, Uh, Xu, Rb, Hhd, Hhd, Gll^Fdw, Mm, Mm^Xm, Wog, Wog, Wog, Wog, Wwg, Mm, Hhd^Fmw, Gll^Fms, Gll^Fdw, Gll^Fmw, Gll^Fdw
Hhd, Hh, Uh, Uu^Tf, Uu, Rb, Uh, Uu^Tf, Rb, Rb, Xu, Md^Xm, Md^Xm, Md^Xm, Md^Xm, Hhd, Uu, Uu, Rb, Rb, Uu^Tf, Uu, Rb, Uu, Uu^Tf, Uh, Xu, Gll^Fdw, Wwf, Wwg, Wog, Xu, Xu, Mm^Xm, Wwg, Hhd^Fdw, Gll^Fmw, Gll^Fmw, Wwg, Gll^Fdw, Gll^Fdw
Md^Xm, Hhd, Xu, Xu, Uu^Tf, Uu, Uu^Tf, Uu, Uu, Uu, Uu^Tf, Xu, Md^Xm, Md^Xm, Md^Xm, Xu, Uh, Uu^Tf, Uh, Uh, Uu, Rb, Uh, Uu, Uu, Xu, Md^Xm, Md^Xm, Wwg, Wwg, Wog, Xu, Qxu, Xu, Xu, Wwg, Wwg, Wwg, Gll^Fdw, Wwg, Wwg
Md^Xm, Md^Xm, Md^Xm, Xu, Uh, Uu, Uu, Rb, Rb, Uh, Xu, Xu, Md^Xm, Md^Xm, Md^Xm, Xu, Xu, Rb, Uu, Uh, Uu^Tf, Uh^Tf, Uh, Rb, Uh, Xu, Xu, Md^Xm, Xu, Ww^Vm, Wog, Wog, Qxu, Qxu, Xu, Md^Xm, Md^Xm, Hh^Fdw, Hhd^Fmw, Gll^Fmw, Gs^Fms
Md^Xm, Md^Xm, Md^Xm, Xu, Xu, Uh, Xu, Uu^Tf, Uu, Xu, Md^Xm, Xu, Md^Xm, Md^Xm, Md^Xm, Md^Xm, Xu, Uu^Tf, Uh, Rb, Rb, Uh, Uu, Rb, Uu^Tf, Xu, Md^Xm, Md^Xm, Md^Xm, Xu, Qxu, Qxu, Qxu, Qxu, Xu, Md^Xm, Md^Xm, Md, Md, Hhd^Fms, Gll^Fms
Md^Xm, Md^Xm, Md^Xm, Md^Xm, Md^Xm, Xu, Xu, Uh, Hhd, Xu, Md^Xm, Md^Xm, Md^Xm, Md^Xm, Md^Xm, Xu, Xu, Xu, Xu, Uh, Uu, Uu^Tf, Uh, Uu^Tf, Xu, Xu, Xu, Md^Xm, Md^Xm, Xu, Xu, Xu, Xu, Xu, Md^Xm, Md^Xm, Md^Xm, Md, Hh^Fdw, Hh^Fms, Hh^Fms
Md^Xm, Md^Xm, Md^Xm, Md^Xm, Md^Xm, Md^Xm, Md^Xm, Hh, Hh, Md^Xm, Md^Xm, Md^Xm, Md^Xm, Md^Xm, Md^Xm, Md^Xm, Xu, Xu, Xu, Uu, Uu, Uh, Ms, Xu, Xu, Mm^Xm, Xu, Md^Xm, Xu, Md^Xm, Ms, Md^Xm, Md^Xm, Md^Xm, Md^Xm, Md^Xm, Ms, Md^Xm, Md^Xm, Hh^Fdw, Hh^Fdw
