Md, Md, Md^Xm, Md^Xm, Xu, Xu, Xoa, Xoa, Xoa, Xoa, Xoa, Xoa, Xu, Xu, Md^Xm, Md^Xm, Md^Xm, Md^Xm, Md^Xm, Md^Xm, Md^Xm, Md^Xm, Md^Xm, Md^Xm, Md^Xm, Md^Xm, Md^Xm, Md^Xm, Md^Xm, Md^Xm, Md^Xm, Md, Md, Md, Hhd^Fdw, Gll^Fdw, Mm, Hhd^Fmw, Hhd^Fmw, Hh^Fmw, Gll^Fmw
Md^Xm, Md^Xm, Md^Xm, Md^Xm, Xoa, Xoa, Xoa, Xoa, Uu^Vud, Xoa, Xoa, Xoa, Xoa, Xoa, Xoa, Md^Xm, Md^Xm, Md^Xm, Md, Md^Xm, Md, Md^Xm, Md^Xm, Md^Xm, Md^Xm, Md^Xm, Md^Xm, Md^Xm, Md^Xm, Md^Xm, Md^Xm, Md^Xm, Md^Xm, Md, Hhd^Fdw, Md, Gll^Fmw, Hh^Fmw, Hh^Fmw, Mm, Mm
Md, Md^Xm, Md, Md^Xm, Xoa, Ias, Xoa, Ias, Ias, Uu, Xoa, Ias, Ias, Cud^Ii, Xoa, Md^Xm, Md^Xm, Md^Xm, Md, Md, Md, Md, Md, Md^Xm, Md^Xm, Md^Xm, Md, Md^Xm, Md^Xm, Md^Xm, Md^Xm, Md^Xm, Md, Md^Xm, Md, Gll^Fdw, Gll^Fp, Hh^Fmw, Gll^Fmw, Gll^Fmw, Hh^Fmw
Md, Md, Md^Xm, Md^Xm, Md^Xm, Xoa, Uu, Ias^Pw\o, Xoa, Ias^Pw/o, Uu, Xoa, Xu, Xoa, Md^Xm, Md^Xm, Hhd^Em, Md, Hhd^Fmw, Hhd^Fmw, Hhd, Hhd^Fmw, Hhd^Fdw, Md, Md^Xm, Md^Xm, Md, Md, Md, Md^Xm, Md, Md^Xm, Md^Xm, Md, Hhd^Fdw, Hhd^Fdw, Hh^Fdw, Hh^Fp, Hhd^Fp, Hh^Fmw, Gll^Fmw
Md^Xm, Hhd, Md, Md, Xoa, Xoa, Ias, Uu, Xoa, Ias^Es, Uh^Em, Xoa, Md, Md^Xm, Md^Xm, Hhd^Fdw, Hhd^Fdw, Hhd^Em, Md, Hhd^Fdw, Md, Hhd^Em, Hhd^Es, Md^Xm, Md^Xm, Md^Xm, Md^Xm, Md, Md, Md, Hhd^Fmw, Md^Xm, Md^Xm, Md, Md, Hhd^Fp, Hh^Fp, Md, Hhd^Fp, Hhd^Fmw, Hhd^Fdw
Md, Md^Xm, Md, Md, Ias, Uh, Uu^Es, Ias, Uu^Tf, Ias^Es, Uu, Xoa, Md, Md^Xm, Hhd^Fdw, Hhd^Fmw, Md, Md, Md^Xm, Md, Xu, Hhd^Fdw, Uh, Xu, Xu, Xu, Xu, Md^Xm, Md, Hhd^Fdw, Md, Md^Xm, Md^Xm, Md^Xm, Md^Xm, Md, Md, Md, Md, Md, Gll^Fdw
Md, Md, Md, Hhd, Hhd^Es, Uu, Xoa, Uh^Emf, Ias, Uu^Em, Uh, Ias, Hhd^Em, Md, Gll^Fmw, Md, Md, Md^Xm, Md^Xm, Xu, Xu, Uu, Ur, Uu, Uu, Uh^Em, Uu^Tf, Xu, Md, Gd, Gd^Fdw, Md, Md, Md^Xm, Md^Xm, Md^Xm, Md^Xm, Md, Md, Md, Hhd^Fdw
Gd^Em, Hhd^Fmw, Hhd^Fdw, Hhd^Em, Hhd^Fdw, Md, Md, Xoa, Xoa, Xoa, Hhd^Fdw, Gd, Md, Gd^Fdw, Gll^Fdw, Hhd^Fdw, Md, Md, Md^Xm, Xu, Uu^Tf, Uu^Em, Uu, Ur^Edb, Uu^Edb, Ur^Edb, Ur^Es, Xu, Uh, Hhd^Em, Hhd^Fdw, Hhd^Fmw, Md, Md^Xm, Md^Xm, Md^Xm, Md, Md^Xm, Md, Hhd^Fmw, Hhd^Fmw
Gd, Gd^Fdw, Md, Md, Md, Md, Md, Md, Md, Md, Hhd^Fdw, Md, Hhd^Fdw, Gd^Es, Hhd^Em, Hhd^Fdw, Md, Md^Xm, Md^Xm, Xu, Uh^Em, Ur^Es, Uu, Uh^Edb, Ur^Edb, Uu^Tf, Uu^Em, Uh, Hhd^Fdw, Gd^Em, Gd^Fmw, Hhd^Fmw, Md^Xm, Md, Md^Xm, Md^Xm, Md, Hhd^Fdw, Hhd^Fmw, Md, Md
Gd^Fdw, Re, Hhd, Hhd, Gd^Fdw, Hhd, Hhd^Fdw, Md, Md, Md, Md, Hhd, Gd^Fdw, Re^Es, Hhd, Md, Md^Xm, Md^Xm, Md^Xm, Xu, Xu, Ur, Uu^Tf, Uu^Em, Ur^Es, Uu, Xu, Uh, Md, Hhd^Fdw, Md, Md^Xm, Md, Md^Xm, Md, Md^Xm, Hh^Fdw, Hhd^Fdw, Hhd^Fmw, Md, Hhd^Fdw
Re, Re^Es, Ce, Ce, Re^Vct, Re^Fdw, Re, Re^Es, Re, Hhd, Hhd^Fdw, Hhd, Re^Es, Re, Gd^Fdw, Md, Md, Md^Xm, Md^Xm, Md^Xm, Hhd^Edb, Uu, Uh^Em, Uh^Emf, Uu^Tf, Uh^Em, Xu, Mm^Xm, Mm^Xm, Md, Md, Md, Md, Md, Md^Xm, Md^Xm, Md, Hh^Fmw, Hhd^Em, Hh^Fp, Hh^Fdw
Hhd^Em, Re^Es, Re^Vct, 1 Ke, Ce, Re^Ecf, Gd, Gd^Fdw, Hhd^Fdw, Hhd, Gd, Gd, Hhd, Gd^Fdw, Hhd^Fmw, Hhd^Fdw, Hhd, Md, Md, Md, Hhd^Fdw, Hhd^Fdw, Xu, Xu, Xu, Xu, Xu, Xu, Xu, Mm^Xm, Hhd, Hhd^Fdw, Xu, Xu, Xu, Md^Xm, Md, Md, Hhd^Fp, Hh^Fmw, Gll^Fdw
Hhd^Fdw, Gd^Fdw, Hhd^Fdw, Ce, Hhd^Em, Hhd^Fdw, Hhd^Fdw, Hhd^Em, Hhd^Fmw, Hhd^Fdw, Md, Hhd^Fdw, Md, Hhd, Md, Hhd, Md, Hhd^Fmw, Hhd^Fdw, Hhd, Rb^Es, Md, Md^Xm, Md^Xm, Md^Xm, Md^Xm, Xu, Xu, Qxu, Xu, Ur, Uh^Es, Uh, Qxu, Qxu, Md, Md, Md, Hh^Em, Gd^Fmw, Gll^Fdw
Md, Hhd^Fdw, Md, Md, Md, Md, Md, Md, Md, Md, Md, Md^Xm, Md^Xm, Md, Md, Md, Md, Hhd^Fdw, Rb^Edb, Hhd^Edb, Hhd^Fdw, Md, Md, Md^Xm, Md^Xm, Md^Xm, Md^Xm, Xu, Qxu, Qxu, Uh, Ur^Es, Uu, Uu^Tf, Uh^Emf, Xu, Md, Hhd^Fmw, Hh^Fmw, Hh^Fdw, Hh^Fdw
Md, Md, Md^Xm, Md^Xm, Md^Xm, Md^Xm, Md^Xm, Md, Hhd^Fdw, Hhd^Fdw, Md, Md^Xm, Md, Md, Hhd^Fdw, Md, Hhd, Rb, Hhd^Es, Rb^Edb, Hhd^Fdw, Md, Md^Xm, Md, Md^Xm, Md^Xm, Xu, Xu, Xu, Uu^Tf, Uu, Uu, Uh, Uu^Em, Ur^Em, Xu, Gd^Es, Gd^Fdw, Gs, Gd^Em, Gd^Fdw
Md, Md, Md^Xm, Md^Xm, Xu, Md^Xm, Xu, Hhd, Uh, Md, Mm^Xm, Md, Md, Hhd, Re^Edb, Rb^Edb, Rd^Edb, Md, Md, Hhd, Md, Md, Md^Xm, Md^Xm, Md^Xm, Mm, Mm, Xu, Uh, Ur, Ur^Es, Uu, Uu, Ur, Uh, Hhd, Gll^Fdw, Gll, Gd^Es, Gd, Gs
Md^Xm, Md^Xm, Xu, Xu, Uu^Tf, Xu, Uu, Uh, Uu, Xu, Xu, Mm^Xm, Md, Md, Re^Es, Rd^Edb, Hhd^Es, Md, Md^Xm, Md^Xm, Md^Xm, Md^Xm, Md^Xm, Md^Xm, Mm, Mm, Mm, Hh^Fdw, Hhd, Hhd^Es, Uu^Tf, Uh^Em, Qxu, Xu, Md, Hhd, Hhd^Em, Gd^Em, Gd^Em, Gs^Fdw, Gs
Md^Xm, Md^Xm, Xu, Uh^Em, Uu, Uh^Em, Uu, Ur^Es, Uu, Xu, Uh^Em, Hhd, Rb, Rb^Es, Rb, Md, Md, Md, Xu, Xu, Xu, Xu, Xu, Md^Xm, Xu, Mm, Gd^Em, Hh, Mm, Xu, Xu, Qxu, Xu, Xu, Md, Md, Hhd^Fdw, Hhd^Fmw, Hhd^Fp, Gll^Fmw, Gll^Fmw
Md, Md, Ur^Es, Ur, Uh^Em, Ur^Es, Ur^Edb, Ur^Edb, Ur^Edb, Uu^Tf, Uu, Hhd, Md, Hhd^Fdw, Hhd, Hhd^Fdw, Hhd, Xu, Uh^Em, Uu^Tf, Uu^Em, Uh^Em, Uh, Xu, Ur, Hhd^Es, Hhd^Em, Gll^Fdw, Mm, Md, Wog, Wog, Wog, Wog, Wog, Mm, Hhd^Fmw, Gd, Gll^Em, Gd^Fmw, Gll^Fdw
Hhd^Fmw, Hhd^Em, Uh, Uu^Tf, Uu, Ur, Uh, Uu, Ur^Edb, Ur^Es, Xu, Md, Md, Hhd^Fdw, Md, Hhd^Fdw, Uu, Uu, Ur^Es, Ur, Uu^Tf, Uu, Ur, Uu, Uu^Tf, Uh^Em, Xu, Gd^Fdw, Wwg, Wog, Wog, Xu, Xu, Md, Wwg, Hhd^Fdw, Gll^Fmw, Gll^Fmw, Wwg, Hhd^Fdw, Hhd^Fdw
Md, Hhd^Fdw, Xu, Xu, Uu, Uu^Edb, Uu, Uu, Uu, Uu^Em, Uu^Tf, Xu, Md^Xm, Md, Md^Xm, Xu, Uh^Em, Uu^Tf, Uh, Uh, Uu, Ur^Es, Uh, Uu, Uu^Em, Xu, Md, Md, Wwg, Wwg, Wog, Xu, Qxu, Xu, Xu, Wwg, Wwg, Wwg, Gll^Em, Wwg, Wwg
Hhd^Fmw, Hhd^Fdw, Md, Xu, Uh^Em, Uu^Edb, Uu, Ur, Ur^Es, Uh^Em, Xu, Xu, Md^Xm, Md^Xm, Md^Xm, Xu, Xu, Ur^Es, Uu, Uh, Uu^Tf, Uh^Tf, Uh, Ur^Es, Uh^Em, Xu, Xu, Md^Xm, Xu, Ww^Vm, Wog, Wog, Qxu, Qxu, Xu, Md, Md, Hh^Fdw, Hh^Fmw, Gll^Fmw, Gs^Fms
Md, Hhd^Fmw, Md, Xu, Xu, Uh^Emf, Xu, Uu^Tf, Uu^Em, Xu, Md^Xm, Xu, Md^Xm, Md^Xm, Md^Xm, Md^Xm, Xu, Uu^Tf, Uh^Em, Ur^Es, Ur, Uh, Uu, Ur^Es, Uu^Tf, Xu, Md^Xm, Md^Xm, Md^Xm, Xu, Qxu, Qxu, Qxu, Qxu, Xu, Md^Xm, Md, Md, Md, Hhd^Fmw, Gll^Fp
Md^Xm, Md, Md^Xm, Md^Xm, Md, Xu, Xu, Uh^Emf, Uh, Xu, Md, Md^Xm, Md^Xm, Md^Xm, Md^Xm, Xu, Xu, Xu, Xu, Uh, Uu, Uu^Tf, Uh^Emf, Uu^Tf, Xu, Xu, Xu, Md^Xm, Md^Xm, Xu, Xu, Xu, Xu, Xu, Md^Xm, Md^Xm, Md^Xm, Md, Hh^Fdw, Hh^Fp, Hh^Fp
Md^Xm, Md^Xm, Md^Xm, Md^Xm, Md^Xm, Md, Md^Xm, Hhd, Hh, Md, Md^Xm, Md^Xm, Md^Xm, Md^Xm, Md^Xm, Md^Xm, Xu, Xu, Xu, Uu, Uu, Uh^Em, Ms, Xu, Xu, Mm^Xm, Xu, Md^Xm, Xu, Md^Xm, Ms, Md^Xm, Md^Xm, Md^Xm, Md^Xm, Md^Xm, Ms, Md^Xm, Md^Xm, Hh^Fp, Hh^Fdw
