Hh^Fdw, Hh^Fmw, Hh^Fmw, Gll^Fp, Gll^Fmw, Gll^Fp, Hh, Hh^Fp, Hh^Fp, Hh^Fp, Hh^Fp, Mm, Mm, Wo, Wo, Md, Wo, Md, Md, Hh, Hhd, Hhd, Hhd, Md, Md, Hh, Hhd^Fp, Gll^Fp, Gll^Fp, Hh, Mm, Gs, Mm, Hh, Hh^Fmw, Mm, Re, Mm, Mm, Mm, Hh^Fp, Mm, Mm, Mm^Xm, Mm^Xm, Mm^Xm, Mm^Xm
Hh^Fp, Gll^Fdw, Gll^Fp, Hh^Fmw, Hh^Fp, Gll^Fmw, Hh^Fdw, Mm, Mm, Mm, Mm, Mm, Mm, Mm, Wo, Wo, Md, Md, Md, Md, Md, Md, Md, Md, Md, Md, Md, Hhd, Hhd^Fp, Hhd^Fp, Hhd^Fmw, Mm, Mm, Mm, Mm, Hh^Fdw, Re, Mm, Mm, Mm, Hh^Fp, Mm, Mm, Mm^Xm, Mm^Xm, Mm^Xm, Mm^Xm
Hh^Fp, Gs^Fmw, Hh^Fp, Hh^Fp, Hh^Fp, Hh^Fdw, Mm, Mm, Mm, Mm, Hh^Fmw, Mm, Wo, Wo, Md, Hhd, Hhd, Hhd, Md, Md, Md, Md, Md, Md, Md, Md, Hhd^Fdw, Md, Hhd^Fmw, Hhd^Em, Hh^Fmw, Mm, Mm, Mm, Mm, Hh^Em, Hh, Re^Es, Mm, Hh^Es, Mm, Mm, Mm, Mm^Xm, Mm^Xm, Mm^Xm, Mm^Xm
Hh, Hh^Em, Hh^Emf, Gs^Fmw, Hh^Fp, Mm, Hh^Fmw, Hh^Fmw, Mm, Hh^Fmw, Hh^Em, Wo, Ww, Wo, Ds, Md, Hhd, Hhd^Vd, Hhd, Cf, 4 Kf, Hhd, Cf, Hhd, Hhd, Hhd^Em, Hhd^Fdw, Hhd^Fmw, Md, Md, Hh^Fdw, Mm, Hh^Em, Mm, Hh^Fmw, Mm, Re, Re, Hh^Vhh, Mm, Hh^Fmw, Mm, Mm, Mm, Mm^Xm, Mm, Mm^Xm
Hh, Mm, Hh, Hh^Fmw, Gs^Fmw, Hh^Fmw, Hh^Emf, Hh^Fdw, Hh^Fdw, Hh^Fmw, Ww, Ww, Hhd, Ds, Gd^Es, Rd, Rd, Hhd, Rd^Es, Cf, Cf, Cf, Cf, Rb, Rb, Rb^Es, Hhd^Vd, Hhd^Em, Hhd^Fmw, Md, Hh^Es, Hh, 5 Ke, Mm, Mm, Hh, Re, Re, Hh, Mm, Mm, Hh, Mm, Mm, Mm^Xm, Mm^Xm, Wo
Gll^Fp, Mm, Gll^Fmw, Gs^Fp, Gs^Em, Gll^Fmw, Gs^Fmw, Hh^Em, Gll^Fp, Hh^Fmw, Ww, Ww, Ds, Hhd, Gd, Hhd, Hhd^Vd, Rd, Re, Rb, Rb, Rb^Edb, Rb, Rd^Es, Re, Hhd, Hhd^Fdw, Hhd, Hh^Fmw, Hhd^Fmw, Hh, Ce, Ce, Ce, Hh^Fmw, Mm, Hh, Re, Wo, Wo, Wo, Wo, Wo, Wo, Wo, Wo, Mm^Xm
Hh, Gll^Fdw, Gs^Fmw, Gll^Fmw, Hh, Gll^Fdw, Hh, Gs, Gll^Fmw, Gs^Vl, Gs, Ww, Ww, Hhd, Hhd, Rd, Re, Gd, Re, Re^Es, Rb, Rb, Re, Rd^Es, Re, Gd, Gd^Fdw, Gs^Fmw, Gll^Fp, Gll^Fp, Hh, Gd^Vct, Hh, Hh^Fdw, Hh, Hh, Wo, Wo^Bsb|, Hh, Hh, Mm, Mm, Mm, Wo, Mm, Wo, Mm^Xm
Hh^Fmw, Hh^Fmw, Hh^Fmw, Hh^Fmw, Hh^Fp, Hh, Hh^Fdw, Hh, Gs^Em, Gs^Fdw, Gd, Gd, Ds, Ww, Ww, Gs^Fp, Gs, Gd, Gs, Re, Re^Edb, Re^Edb, Gd^Fmw, Gd^Fdw, Gd^Em, Gd^Fmw, Hh^Fp, Hh^Em, Hh^Fmw, Gs^Fp, Gs^Fmw, Gd^Em, Gd^Fdw, Gs^Fdw, Ww, Wo, Cud, Re, Hh^Em, Hh^Fmw, Mm, Mm, Mm, Mm, Mm, Mm^Xm, Mm^Xm
Hh, Mm, Mm, Mm, Mm, Mm, Hh^Fdw, Hh^Fdw, Gs, Gs, Gs^Fdw, Gd^Es, Ds, Ww, Ww, Ww, Gs, Re^Vh, Re^Es, Re, Gd, Re, Hh, Hh^Fmw, Gll^Fp, Gd^Fmw, Hh^Fmw, Hh^Fmw, Ce, Hh^Fmw, Gll^Fp, Hh^Fmw, Hh^Fdw, Gs, Ww, Re^Es, Re^Es, Re, Hh^Fmw, Mm, Mm, Mm, Mm, Mm, Mm^Xm, Mm^Xm, Mm^Xm
Gll^Fp, Hh^Emf, Mm, Mm, Gll^Fp, Hh, Hh^Em, Hh, Gs, Gs, Gd, Gd, Gd, Ds, Ds, Ww, Ww, Re^Gvs, Re^Gvs, Re, Re, Gll^Fmw, Gll^Fp, Gs^Fdw, Gll^Fp, Hh^Fmw, Hh^Vct, 6 Ke, Ce, Hh, Hh^Fmw, Hh^Fp, Ww, Ww, Hh, Re, Re, Hh, Hh^Fp, Hh^Fp, Mm, Mm, Mm, Mm, Mm^Xm, Mm^Xm, Mm^Xm
Hh, Mm, Mm, Mm, Hh, Gs^Fmw, Gd, Gs, Re^Gvs, Re^Gvs, Re^Gvs, Gd, Gd, Gd, Gd^Es, Ds, Ww, Re^Gvs, Re^Gvs, Re^Gvs, Gd, Re, Re, Gs^Em, Hh^Fmw, Hh^Fdw, Hh^Em, Hh^Fdw, Re^Gvs, Re^Es, Hh, Ww, Hh^Em, Mm, Hh^Fp, Hh^Em, Re, Hh, Hh^Em, Hh^Vhh, Mm, Mm, Mm, Mm, Mm^Xm, Mm^Xm, Mm^Xm
Hh^Fp, Hh^Fp, Hh^Fmw, Hh, Gs^Fdw, Gs^Em, Gs^Fdw, Gs, Hh, Re^Gvs, Hh^Em, Hh, Hh, Gd, Gs^Vc, Gd, Ww, Re^Gvs, Re^Gvs, Re^Gvs, Hh^Em, Gs^Fmw, Re, Hh^Fdw, Hh, Hh^Fmw, Hh, Hh^Vhh, Re^Gvs, Re, Ww, Ww, Mm, Mm, Mm, Mm, Re, Hh, Re^Gvs, Hh^Fdw, Cud, Cud, Cud, Mm, Mm^Xm, Mm, Mm^Xm
Gll^Fp, Hh^Fmw, Hh^Em, Hh^Fdw, Hh^Fmw, Gd, Gd, Hh, Hh, Hh^Fdw, Re^Gvs, Re^Gvs, Re^Gvs, Gd, Re, Gd, Ww, Ww, Ww, Hh, Hh^Fdw, Gll^Fdw, Ww^Bw|, Re, Hh, Hh, Re^Gvs, Re^Gvs, Re^Gvs, Re^Gvs, Ww, Ww, Hh^Fp, Mm, Gs^Fmw, Hh, Re^Gvs, Re^Gvs, Re^Gvs, Hh, Mm, Cud, Mm, Mm, Mm, Mm, Mm
Hh^Fmw, Gs^Fmw, Gll^Fp, Gll^Fp, Gs^Em, Gd, Gs, Re, Re, Re^Gvs, Re^Gvs, Re^Gvs, Re^Gvs, Re^Gvs, Re^Vwm, Re, Gd, Ww, Ww, Ww, Ww, Ww, Re, Ww, Ww, Hh^Fdw, Hh, Re^Gvs, Ww, Ww, Ww, Hh^Em, Hh^Fmw, Mm, Gs, Re, Re^Gvs, Re^Gvs, Re^Gvs, Re^Gvs, Mm, Mm^Xm, Cud, Mm^Xm, Mm^Xm, Mm^Xm, Mm^Xm
Hh, Gll^Fp, Gs^Emf, Hh^Fmw, Hh^Fdw, Hh, Gs, Gs, Re^Es, Re^Eff, Re^Eff, Re^Gvs, Re^Gvs, Re^Gvs, Re^Eff, Re, Gd, Hh, Hh, Hh, Hh^Fdw, Gd, Gd, Re, Ww, Ww, Ww, Ww, Ww, Ww, Ww, Hh^Fmw, Hh, Hh^Fmw, Gd, Re^Es, Re, Re^Gvs, Hh, Hh, Mm^Xm, Mm^Xm, Uh, Cud, Kud, Mm^Xm, Mm^Xm
Gll^Fmw, Gll^Fmw, Gll^Fmw, Hh, Re^Vh, Hh, Re, Re, Re, Re, Gd, Re^Eff, Re^Eff, Re^Eff, Re^Es, Gd, Hh, Hh^Fmw, Hh, Hh^Fmw, Hh^Fmw, Re^Vct, Re, Re, Ce, 7 Ket, Ce, Ww, Ww, Ww, Ww, Gs, Hh^Fdw, Re^Gvs, Gd, Rr, Re, Re, Cud, Mm, Uh, Uh^Vud, Rr, Cud, 2 Cud, Cud, Mm
Gs^Fp, Gs^Fmw, Gs^Fmw, Gd^Em, Re, Re, Re^Gvs, Re^Gvs, Re^Gvs, Gd, Gs, Gd, Gd, Gd, Re, Re^Es, Gs, Gll, Gs^Em, Gll^Fdw, Hh^Vhh, Hh^Fdw, Re, Ce, Ce, Ce, Ww^Bw\, Ww, Ww, Ww, Hh, Hh^Fdw, Re^Gvs, Re^Gvs, Re, Rr, Hh, Cud, Rr, Rr^Vud, Rr, Rr, Rr, Uh, Uh, Cud, Hh
Gll^Fdw, Gs^Fmw, Gs, Gd, Re^Eff, Re^Gvs, Re^Gvs, Re^Gvs, Re^Gvs, Re^Gvs, Hh, Hh, Hh, Hh, Re, Hh^Fdw, Gs^Em, Gs, Gll, Hh, Gll^Fdw, Hh, Re, Re^Vct, Ww, Ww, Ww, Ce, Ww, Gs, Hh, Hh, Re^Gvs, Re^Gvs, Re, Rr, Cud, Rr^Ebn, Rr, Cud, Rr, Rr^Vud, Cud, Uh^Vud, Mm^Xm, Mm^Xm, Mm^Xm
Gs, Gll^Fdw, Gs, Gs^Fmw, Gs^Fdw, Re^Eff, Re^Eff, Re^Gvs, Gs^Vht, Re, Gd, Hh^Fdw, Hh^Fmw, Hh, Re, Hh, Gll^Fmw, Gs^Fdw, Gs, Gll^Fmw, Re, Re, Hh, Re, Ww^Bsb\, Ww, Ww, Ww^Bw|, Gs^Fdw, Gs, Gd, Gd, Rr, Rr, Rr^Es, Rr, Rr, Rr^Eqf, Rr^Eqf, Rr^Ebn, Hh, Cud, Uh, Mm, Mm^Xm, Mm^Xm, Mm
Gs^Fdw, Gs, Gs^Vct, Ce, Ce, Ce, Re^Es, Re, Re, Gs, Gs^Fdw, Hh^Fp, Gs^Em, Gs, Re, Gll^Fmw, Re, Gll^Fdw, Re, Re, Gll^Fmw, Hh^Fdw, Ww, Ww, Ww, Ww^Bsb\, Rr, Gs, Gs, Gs^Es, Rr^Es, Rr, Gs, Re, Re, Gd, Gd, Re, Hh, Cud, Re, Hh, Mm, Mm, Mm, Mm, Mm
Re, Gs, Ce, 1 Ke, Ce, Re^Vct, Re, Re, Re, Re, Re, Hh, Re, Gs, Gs, Re, Re^Es, Re, Gs^Fdw, Gs^Em, Gs^Fp, Gll^Fmw, Ww, Ww, Gll^Fdw, Cud, Gll^Fdw, Rr, Rr, Rr, Gd, Gs, Gd^Eff, Re^Eff, Re^Gvs, Gd^Vh, Re, Gd, Re, Re^Es, Re^Es, Hh, Cud, Mm, Mm, Mm, Hh
Gs, Re, Re^Es, Ce, Re, Re, Re, Re, Gs, Gs^Em, Gs^Fdw, Re, Re, Re, Re, Re, Gs, Gll, Gll^Fmw, Gll^Fmw, Gll^Fp, Gll^Fp, Ww, Ww, Gll^Fmw, Gll^Em, Gs^Es, Gll, Gs^Vc, Gd, Re^Eff, Gd^Eff, Re^Gvs, Re^Gvs, Re^Gvs, Re^Gvs, Cud, Hh, Hh, Hh, Re, Cud, Cud, Cud, Mm, Mm, Mm
Gs, Gll^Fdw, Gs, Re, Gs, Gs, Gs, Re^Es, Re, Gll^Fmw, Gll^Fmw, Gs^Vc, Re, Re, Ce, Ce, Gll^Fmw, Gll, Gll^Em, Gll^Emf, Gll^Fmw, Ww, Gll^Fdw, Ww, Ww, Gs, Gs^Fdw, Gd, Gd, Gs, Gs, Re^Eff, Re^Eff, Re^Gvs, Re^Gvs, Re^Gvs, Cud, Hh, Gd, Hh, Hh^Vhh, Hh, Mm, Mm, Mm, Mm^Xm, Mm
Gll^Fmw, Gll^Em, Gs^Fdw, Gs^Fdw, Gll^Fmw, Gll^Fmw, Re^Gvs, Re^Gvs, Re^Gvs, Re^Gvs, Re^Gvs, Gll^Fmw, Gll, Re, Ce, 8 Ke, Gll^Fmw, Gs^Fdw, Gs, Gs, Ww, Ww, Gs^Fp, Gll^Fmw, Ww, Gs, Hh^Fdw, Gs^Fmw, Ww, Ww, Ww, Gd, Gd^Es, Re^Eff, Gd, Cud, 3 Kud, Gd^Es, Gs^Es, Hh, Hh, Hh, Hh^Es, Mm, Mm, Mm^Xm, Mm
Gll^Fmw, Gs^Em, Gll^Fp, Gll^Fp, Gll^Fp, Re^Gvs, Re^Gvs, Re^Gvs, Re^Gvs, Re^Gvs, Gll^Fdw, Gs^Fp, Gll^Fmw, Gs^Fmw, Gs^Em, Gll^Fmw, Gs, Gs, Gs^Fdw, Ww, Ww, Ww, Gll^Fp, Gs^Fp, Ww, Hh, Ww, Ww, Ww, Ww, Ww, Gs^Fdw, Gs^Fmw, Gs, Gd, Gd, Re^Eff, Gd, Gs^Em, Gll^Fdw, Gll^Fmw, Hh^Em, Hh, Mm, Mm^Xm, Mm, Mm
Gll^Fmw, Gs^Fmw, Gll^Fp, Gs^Fmw, Gll^Fmw, Gll^Fdw, Gll^Fmw, Re^Gvs, Gll^Fp, Gs^Vl, Gll^Fp, Gs^Fdw, Gs^Fmw, Gs^Fmw, Gll^Fp, Gs, Gs, Gs, Gs^Fdw, Ww, Gs^Fp, Gll^Em, Gll^Fp, Gs^Fp, Gll^Em, Ww, Hh^Fmw, Hh^Fmw, Hh, Ww, Ww, Ww, Gs, Gs^Es, Re^Eff, Re^Eff, Re^Gvs, Re^Eff, Re^Eff, Hh, Gd^Fdw, Hh^Em, Hh, Hh^Fmw, Mm, Mm, Mm
Gll^Fp, Gs^Fp, Gd^Fmw, Gs^Fmw, Gll^Fmw, Gs^Fmw, Gll^Fmw, Gll^Fmw, Gll^Fp, Gll^Fp, Gll^Fp, Gll^Fp, Gs^Fmw, Gll^Fp, Gll^Fmw, Gll^Fmw, Gs, Gd^Em, Ds, Ww, Gs, Gs^Fp, Gll, Gll^Fmw, Gll^Emf, Hh^Fdw, Gll^Em, Hh^Fmw, Hh^Fdw, Gs^Fmw, Gll^Fmw, Gll^Fdw, Gs, Re, Re^Gvs, Re^Gvs, Re^Gvs, Re^Gvs, Re^Gvs, Re, Hh^Es, Mm, Hh^Fp, Mm, Mm, Mm, Mm
Gll^Fmw, Gs^Fmw, Gs^Fdw, Gd^Fdw, Gd^Fdw, Gs^Em, Gs, Gd^Fmw, Gd^Fmw, Gs^Em, Gll^Fp, Gll^Fmw, Gll^Fmw, Gll^Fp, Gs^Em, Gs, Gs, Gd^Fdw, Ds, Ww, Gs, Gs^Fmw, Gll^Fp, Gll^Fmw, Gll^Fmw, Gll^Fp, Gll^Fp, Gll^Fmw, Gs^Fmw, Gs, Gs, Gll, Gll^Em, Re, Re^Gvs, Re^Gvs, Re^Gvs, Re^Vwm, Hh^Fmw, Hh, Gs^Fmw, Mm, Hh^Fp, Mm, Mm, Mm, Mm
Gll^Fp, Gs^Em, Ds, Ds, Ds, Ds, Ds, Gd^Fdw, Gd^Fdw, Gs^Fmw, Gs, Gll^Fmw, Gd, Gll^Fmw, Gd, Gs, Gs^Vht, Ds, Ww, Ww, Gg^Fp, Gll^Fp, Gg^Fp, Gll^Fp, Gll, Gs^Fmw, Gs^Fmw, Gs^Fmw, Gs^Fmw, Gs^Fmw, Hh, Hh^Vhh, Gll^Fmw, Hh, Hh, Re^Gvs, Re, Hh^Fmw, Gs^Fmw, Hh^Em, Mm, Mm, Mm, Mm, Mm, Mm^Xm, Mm
Gd^Fp, Gd, Ww, Ww, Ww, Ww, Ww, Ds, Ds, Gd, Gs, Gll^Fmw, Gd^Es, Gd, Ds, Ds, Ds, Ds, Ww, Ww, Gg^Fp, Gll^Fms, Gg^Fms, Gs^Vl, Gll^Fp, Gs^Es, Gs, Gs^Fp, Gs^Fp, Hh, Hh, Hh, Hh, Gll^Fmw, Hh, Hh, Hh^Fp, Hh^Fp, Gs^Fmw, Hh^Fp, Mm, Mm, Mm, Mm, Mm, Mm^Xm, Mm^Xm
Gll^Fp, Ww, Gs^Fmw, Gll^Fp, Gll^Fp, Gll^Fp, Gs^Fmw, Ww, Ww, Gd^Fdw, Gs^Fdw, Gs, Ds, Gs, Ds, Ww, Ww, Ww, Ww, Ww, Ww, Gg^Fms, Gs^Fms, Gg^Fp, Gs^Fms, Gg^Fp, Gg, Gs^Fp, Hh, Hh, Mm, Hh^Fp, Hh^Fmw, Hh^Fp, Hh^Fmw, Mm, Hh^Fp, Hh, Hh^Fms, Mm, Mm, Mm, Mm, Mm, Mm, Mm^Xm, Mm^Xm
Ww, Ww, Gll^Fp, Gll^Fp, Gs^Fp, Gll^Fmw, Gll^Fp, Gs, Ww, Ww, Ww, Ww, Ww, Ds, Ds, Ww, Ww, Ww, Ww, Ww, Gg^Efm, Gg, Gs^Fms, 9 Gg^Fp, Gg^Fp, Gg^Efm, Gg^Ve, Gg^Fmw, Mm, Mm, Mm, Hh^Fmw, Mm, Hh^Fp, Gs^Fmw, Mm, Mm, Hh^Fms, Hh^Em, Hh^Fp, Hh^Fp, Mm, Hh^Fp, Mm, Hh^Fp, Mm, Mm
Gll^Fp, Gll^Fp, Gs^Fmw, Gs^Fp, Gs^Fmw, Gll^Em, Gll, Gll^Fp, Gll^Fmw, Ww, Ww, Ww, Ww, Ds, Ww, Ww, Ww, Ww, Ww, Gg, Gg^Em, Gg^Fp, Gg^Fp, Gg^Fms, Gg^Fp, Gg^Fp, Gg^Fp, Hh, Hh^Fp, Mm, Mm, Hh^Fp, Mm, Hh^Fp, Mm, Gs^Fp, Mm, Mm, Mm, Mm, Gs^Fp, Hh, Hh^Fp, Hh^Fp, Mm, Mm, Mm
Gll^Fp, Gs^Fmw, Gs^Fms, Gs^Fms, Gs^Fms, Gs^Fmw, Gs^Fp, Gll^Fp, Gg^Fmw, Gll^Fmw, Gll^Fp, Ww, Ww, Ww, Ww, Ww, Ww, Ww, Gg^Ve, Gg, Gg^Fp, Gg^Fp, Gg^Fp, Gg^Fms, Gs^Fds, Gs^Fms, Gs^Fp, Hh^Fp, Hh^Fp, Mm, Hh^Fp, Hh, Hh, Mm, Hh^Fp, Hh^Fp, Gg^Em, Gg^Fms, Hh^Fms, Mm, Gs^Fp, Gg^Fp, Gs^Fms, Gs^Fms, Hh^Fms, Hh^Fms, Hh^Fp
Gll^Fp, Gs^Fmw, Gll^Fms, Gs^Fms, Gs^Fms, Gs^Fp, Gs^Fms, Gs^Fms, Gs^Fms, Gg^Fp, Gg^Fmw, Gs, Gll^Fp, Ww, Gll^Fp, Ww, Gg^Fp, Gg^Fmw, Gs^Fms, Gs^Fms, Gg^Fms, Gg^Fp, Gg^Fms, Gg^Fms, Gg^Fds, Gg^Fms, Gs^Fds, Gs^Fms, Gs^Fms, Gg^Fms, Gg^Fms, Hh^Fms, Gg^Efm, Hh, Hh^Fms, Hh^Fp, Mm, Mm, Mm, Mm, Hh^Fp, Hh, Gs^Fp, Gs^Fms, Gg^Fms, Hh^Fms, Hh
Gll^Fp, Gs^Em, Gs^Fms, Gg^Efm, Gs^Fp, Gll^Fds, Gg^Fms, Gs^Fms, Gg^Fp, Gg^Fms, Gll^Fms, Gg^Fmw, Gs^Em, Gll^Fmw, Gll^Fmw, Gg^Em, Gs^Fmw, Gg^Efm, Gg^Fp, Gg^Fms, Gll^Fp, Gg^Fms, Gg^Fms, Gg^Fp, Gg^Fds, Gs^Fds, Gs^Fms, Gg^Fms, Gg^Efm, Gg^Fp, Gg^Fms, Gg^Fms, Hh^Fds, Hh^Fms, Hh^Em, Hh, Mm, Mm, Mm, Mm, Mm, Hh^Fms, Hh^Fms, Gg^Fds, Gg^Fms, Gg^Fds, Gg^Fms
Gs^Fms, Gs^Fp, Gs^Fms, Gs^Fp, Gg^Efm, Gg^Fp, Gg^Fms, Gs^Fds, Gs^Fds, Gll^Fms, Gs^Fp, Gs^Emf, Gll^Fmw, Gg^Fp, Gll^Fp, Gs^Fmw, Gs, Gs^Fmw, Gll^Fp, Gg^Fp, Gs^Fms, Gs^Fms, Gg^Fp, Gg^Fds, Gll^Fp, Gs^Fds, Gs^Fms, Gs^Fms, Gs^Fp, Gs^Fms, Gs^Fp, Hh^Fms, Hh^Fp, Hh^Fms, Hh^Fms, Hh^Emf, Hh^Fms, Hh^Fms, Hh, Mm, Hh^Fp, Hh^Fp, Hh^Fms, Gs^Fp, Gg^Fms, Gg^Fms, Gg^Fms
Gll^Fp, Gll^Fms, Gll^Fp, Gs^Fms, Gs^Fp, Gg, Gll^Fp, Gg^Fds, Gll^Fp, Gll^Fds, Gs^Fds, Gs^Fp, Gs^Fp, Gll^Fmw, Gll^Fp, Gs, Gs, Gs, Gll^Fp, Gs, Gll^Fp, Gll^Fp, Gll^Fp, Gll^Fp, Gll^Fp, Gll^Fp, Gll^Fp, Gll^Fp, Gll^Fp, Gs^Fp, Hh, Hh, Gll^Fp, Hh, Gs^Fp, Hh^Fms, Mm, Mm, Mm, Hh, Mm, Hh^Fp, Mm, Gs^Fp, Mm^Xm, Gs^Fms, Gs^Fp
