Xu, Xu, Xu, Xu, Xu, Xu, Xu, Xu, Xu, Xu, Xu, Xu, Xu, Xu, Xu, Xu, Xu, Xu, Xu, Xu, Xu, Xu, Xu, Xu, Xu, Xu, Xu, Xu, Xu, Xu, Xu, Xu, Xu, Xu, Xu, Xu, Xu, Xu, Xu, Xu, Xu, Xu, Xu, Xu, Xu, Xu, Xu, Xu, Xu, Xu, Xu, Xu, Xu, Xu, Xu, Xu, Xu, Xu, Xu, Xu, Xu, Xu
Xu, Xu, Xu, Xu, Xu, Xu, Xu, Xu, Xu, Xu, Xu, Xu, Xu, Xu, Xu, Xu, Xu, Xu, Xu, Xu, Xu, Xu, Xu, Xu, Xu, Xu, Xu, Xu, Xu, Xu, Xu, Xu, Xu, Xu, Xu, Xu, Xu, Xu, Xu, Xu, Xu, Xu, Xu, Xu, Xu, Xu, Xu, Xu, Xu, Xu, Xu, Xu, Xu, Xu, Xu, Xu, Xu, Xu, Xu, Xu, Xu, Xu
Xu, Xu, Xu, Xu, Qlf, Xu, Ur, Qlf, Qlf, Xu, Xu, Xu, Xu, Xu, Qlf, Qlf, Qlf, Xu, Xu, Xu, Xu, Xu, Xu, Xu, Xu, Xu, Xu, Xu, Xu, Xu, Xu, Xu, Xu, Xu, Xu, Ur^Vu, Xu, Xu, Xu, Xu, Xu, Xu, Xu, Xu, Xu, Xu, Xu, Xu, Xu, Xu, Xu, Xu, Xu, Xu, Xu, Xu, Xu, Xu, Xu, Xu, Xu, Xu
Xu, Xu, Xu, Qlf, Ur, Ur, Ur, Ur, Ur, Xu, Xu, Xu, Qlf, Qlf, Ur, Qlf, Ur, Ur, Ur, Xu, Xu, Xu, Xu, Xu, Ql, Xu, Ql, Xu, Xu, Xu, Xu, Xu, Xu, Xu, Wwg^Es, Ur^Es, Ur^Ebn, Xu, Wwg^Es, Xu, Ss^Emf, Ss^Vhs, Xu, Xu, Xu, Xu, Qlf, Xu, Xu, Xu, Xu, Xu, Xu, Xu, Xu, Xu, Xu, Xu, Xu, Xu, Xu, Xu
Xu, Xu, Xu, Ur, Ur, Ur, Ur, Ur, Ur, Xu, Ias, Ur, Ur, Ur, Ur, Ur, Ur, Ur, Ur, Ur, Ur, Xu, Xu, Ql, Ql, Ql, Ql, Ql, Ql, Xu, Xu, Uu^Vud, Rb^Em, Wwg^Es, Wwg, Uue, Uu^Es, Ur^Es, Ur, Wwg^Em, Sm^Em, Ss^Em, Xu, Xu, Xu, Qlf, Qlf, Xu, Xu, Xu, Xu, Xu, Xu, Xu, Xu, Xu, Xu, Xu, Xu, Xu, Xu, Xu
Xu, Xu, Xu, Ur, Ur, Ur, Ur, Ur, Ias, Ias, Ur, Ur, Ur, Ur, Qlf, Ur, Qlf, Qlf, Qlf, Ur, Ur, Xu, Xu, Ql, Ur, Ur^Edb, Ur, Ql, Ql, Xu, Xu, Xu, Sm^Emf, Rb^Em, Uue^Es, Uu, Cud, Cud, Cud, Rb, Rb^Es, Rb^Es, Ur^Es, Xu, Xu, Qlf, Ur, Qlf, Qlf, Qlf, Qlf, Xu, Xu, Xu, Xu, Xu, Xu, Xu, Xu, Xu, Xu, Xu
Xu, Xu, Qlf, Qlf, Qlf, Ur, Xu, Xu, Xu, Ur, Qlf, Ur, Ur, Qlf, Qlf, Qlf, Qlf, Qlf, Xu, Ur, Ur^Edb, Xu, Xu, Xu, Ur^Pr\o, Ur^Edb, Ql, Ql, Ql, Xu, Xu, Xu, Sm^Emf, Uue^Em, Uue, Rb^Es, Cud, 4 Kud, Cud, Rb^Es, Rb^Em, Uu^Ebn, Xu, Ur^Pr/, Ur, Ur, Urb^Ii, Ur, Qlf, Qlf, Xu, Xu, Xu, Xu, Xu, Xu, Xu, Xu, Xu, Xu, Xu, Xu
Xu, Xu, Xu, Qlf, Xu, Xu, Xu, Xu, Xu, Xu, Qlf, Ur, Ur, Qlf, Xu, Xu, Xu, Xu, Xu, Ur, Ur, Ur, Uu^Em, Uu^Es, Uh^Em, Xu, Xu, Ql, Xu, Xu, Xu, Xu, Xu, Uue^Em, Rb^Es, Rb, Rb, Cud, Sm^Bw\r, Sm, Sm^Em, Xu, Xu, Xu, Qlf, Ur, Ur, Ur, Qlf, Qlf, Xu, Xu, Xu, Xu, Xu, Xu, Xu, Xu, Xu, Xu, Xu, Xu
Xu, Xu, Xu, Xu, Xu, Xu, Ql, Xu, Qlf, Qlf, Ur, Ur, Ur, Xu, Xu, Xu, Ql, Xu, Xu, Xu, Uu^Pr\o, Uu, Uh^Em, Uh^Emf, Uh^Tf, Xu, Xu, Xu, Xu, Xu, Xu, Xu, Uu^Em, Rb, Ur, Rb, Rb, Sm^Es, Wwg, Sm^Bw\r, Uh^Emf, Xu, Xu, Xu, Qlf, Qlf, Qlf, Qlf, Qlf, Xu, Xu, Xu, Xu, Xu, Xu, Xu, Xu, Xu, Xu, Xu, Xu, Xu
Xu, Xu, Ql, Ql, Ql, Ql, Xu, Qlf, Ur, Ur, Ur, Ur, Uu^Pr/, Xu, Xu, Ql, Ql, Ql, Xu, Ur^Edb, Xu, Xu, Xu, Uh^Emf, Uh^Em, Uh^Emf, Xu, Xu, Xu, Xu, Xu, Uue^Emf, Ur^Es, Ur, Sm, Sm, Rb^Em, Wwg^Em, Wwg^Em, Uue^Emf, Xu, Uh^Vud, Xu, Qlf, Qlf, Qlf, Qlf, Qlf, Xu, Xu, Xu, Xu, Xu, Xu, Xu, Xu, Xu, Xu, Xu, Xu, Xu, Xu
Xu, Xu, Xu, Ql, Xu, Xu, Xu, Xu, Ur^Pr\, Ur, Xu, Uu^Pr/, Ur, Ur, Ur, Ql, Ql, Xu, Ur^Edb, Ur^Edb, Xu, Xu, Xu, Xu, Uu^Em, Uu, Xu, Xu, Xu, Xu, Uu, Uue^Em, Rb^Es, Ur, Uue, Uu^Ebn, Sm^Em, Uh^Emf, Uh^Tf, Xu, Xu, Xu, Xu, Xu, Xu, Xu, Xu, Xu, Xu, Xu, Xu, Xu, Xu, Xu, Xu, Xu, Xu, Xu, Xu, Xu, Xu, Xu
Xu, Xu, Xu, Xu, Qlf, Xu, Ur, Ur, Xu, Xu, Xu, Ur, Ur, Ur, Ql, Ql, Ql, Xu, Uh, Uu^Vu, Xu, Xu, Uh^Vud, Xu, Uu^Es, Uu, Uh^Emf, Xu, Xu, Xu, Cud, Uu, Rb, Uue, Xu, Xu, Xu, Uh^Vud, Uue^Em, Ur^Br\, Ur^Br\, Xu, Xu, Xu, Xu, Xom, Xom, Xu, Wwg^Em, Wwg^Emf, Xu, Xu, Xu, Xu, Xu, Xu, Xu, Xu, Xu, Xu, Xu, Xu
Xu, Xu, Xu, Qlf, Qlf, Ur, Urb^Ii, Ur, Xu, Xu, Ql, Ql, Ql, Ql, Ql, Ql, Xu, Xu, Xu, Xu, Xu, Xu, Uu^Emf, Uh^Tf, Uu^Em, Uu^Em, Uu^Es, Uu^Eb, Xu, Xu, Rb^Es, Rb, Uue^Es, Cud, Xu, Xu, Xu, Xu, Sm^Em, Sm^Em, Wwg^Es, Ur^Br\, Ur^Br\, Xom, Xom, Xom, Ur^Br/, Ur^Br/, Xom, Sm^Tf, Uh^Es, Xu, Xu, Xu, Xu, Xu, Xu, Xu, Xu, Xu, Xu, Xu
Xu, Xu, Xu, Qlf, Qlf, Ur, Ur, Ur, Qlf, Xu, Xu, Ql, Ql, Ql, Xu, Xu, Xu, Xu, Xu, Xu, Uu^Eb, Uh^Vu, Xu, Xu, Uu^Es, Xom, Uu, Uu, Uu^Pw/o, Xu, Ur, Ur, Uue^Es, Xu, Xu, Xu, Xu, Xu, Ss^Em, Sm^Emf, Xom, Wwg^Ewl, Wwg^Em, Ur^Br\, Ur^Br/, Ur^Br/, Wwg, Ur^Br\, Wwg, Xom, Sm^Tf, Uh^Es, Xu, Xu, Xu, Xu, Xu, Xu, Xu, Xu, Xu, Xu
Xu, Xu, Xu, Qlf, Qlf, Qlf, Qlf, Qlf, Qlf, Qlf, Xu, Xu, Xu, Xu, Xu, Xu, Xu, Xu, Xu, Xu, Uh^Emf, Uh^Tf, Uu^Emf, Uu^Em, Xom, Xom, Uu^Pw\o, Xom, Xom, Rb, Ur^Es, Uu, Wwg, Sm^Em, Xu, Xu, Xu, Ss^Ebn, Uue^Ebn, Xom, Xu, Xom, Wwg^Emf, Ur^Br|, Xom, Xom, Xom, Wwg, Sm^Dr, Wwg, Uue^Emf, Xu, Xu, Xu, Xu, Xu, Xu, Xu, Xu, Xu, Xu, Xu
Xu, Xu, Xu, Xu, Xos, Xos, Xos, Qlf, Xos, Xu, Xu, Xu, Xu, Xu, Xos, Xu, Xu, Xu, Xu, Xu, Xu, Uu^Vud, Xu, Uu^Em, Xom, Ur^Es, Ur^Es, Xom, Uu, Rb, Ur^Es, Wwg, Wwg, Sm^Em, Ss^Emf, Xu, Xu, Xu, Xu, Xu, Xu, Ss^Tf, Ss^Emf, Sm^Em, Xom, Xu, Xu, Xu, Xu, Xu, Xu, Xu, Xu, Xu, Xu, Xu, Xu, Xu, Xu, Xu, Xu, Xu
Xos, Xu, Xos^Efs, Xos, Uh, Xos, Xoc, Xos^Efs, Xos, Xos, Xos^Efs, Xos, Xos^Efs, Xos, Xos, Xos, Xos^Efs, Xos, Xos, Xu, Xu, Xu, Xos, Uu, Uu^Es, Ur^Es, Ur^Es, Ur^Es, Ur, Ur, Uu, Uue, Wwg^Em, Xu, Ss^Tf, Xu, Xu, Xu, Xu, Xu, Xu, Xu, Uh^Tf, Wwg^Em, Xu, Xu, Xu, Xu, Xu, Xu, Xu, Xu, Xu, Xu, Xu, Xu, Xu, Xu, Xu, Xu, Xu, Xu
Ur, Xos, Uu^Vud, Uh, Uu^Tf, Uh^Emf, Uh^Em, Xoc, Uu^Vud, Uu, Ur^Es, Ur^Ebn, Uu, Uu^Vu, Uu^Emf, Uu, Uu^Es, Xos, Xos, Xos, Xos, Xos, Uu^Es, Uu^Pw\o, Xom, Xom, Ur, Uu, Uu^Es, Ur, Uue^Em, Wwg, Uue^Ebn, Ss^Emf, Xu, Xu, Xu, Xu, Xu, Xu, Xu, Xu, Xu, Xu, Xu, Xu, Xu, Xu, Xu, Xu, Xu, Xu, Xu, Xu, Xu, Xu, Xu, Xu, Xu, Xu, Xu, Xu
Ur, Uu, Uu, Uu, Ce, Ce, Ce, Uu^Em, Uu, Uu, Uu, Ur, Ur^Es, Uu^Em, Uu, Ur^Es, Ur, Ur, Ur^Pr/, Xos, Uu, Uu^Ebn, Uu^Es, Uu^Es, Uu^Es, Xom, Ur^Es, Uu, Uu^Es, Uu^Vud, Uu^Emf, Uue, Uh^Em, Xu, Xu, Xu, Xu, Xu, Xu, Xu, Xu, Xu, Xu, Xu, Xu, Xu, Xu, Xu, Xu, Xu, Xu, Xu, Cud, Urb^Ebn, Urb, Urb^Vud, Cud, Xu, Xu, Xu, Xu, Xu
Ur, Ur^Es, Ur^Es, Ur, Ce, 1 Ke, Ce, Ur^Es, Ur^Es, Uu^Emf, Ur, Ur, Ur^Vu, Uu^Emf, Ur, Ur, Xos, Ur^Pr/, Ur^Es, Ur, Ur^Es, Ur, Ur^Es, Ur, Cud, Ur^Es, Uu, Uu^Em, Uu^Emf, Uu^Em, Uu^Em, Uu, Uu^Vud, Uh^Tf, Uh^Emf, Xu, Xu, Xu, Xu, Xu, Xu, Xu, Xu, Xu, Xu, Xu, Xu, Xu, Xu, Xu, Uu^Emf, Cud, Uu^Emf, Ur^Es, Ur^Es, Urb, Cud, Xu, Xu, Xu, Xu, Xu
Uu^Es, Ur, Uu^Es, Uu^Em, Uu^Emf, Ce, Uu, Uu, Ur, Ur, Xos, Xos, Xos, Xos, Xos, Xos, Xos, Xos, Xos, Ur, Ur^Es, Ur^Es, Ur, Cud, Cud, Ur^Es, Ur, Uu^Vud, Uu^Emf, Uu^Es, Uu, Ur^Es, Uu^Es, Uu^Emf, Xu, Uh^Tf, Xu, Xu, Xu, Xu, Xu, Xu, Xu, Xu, Ur^Es, Xu, Uu^Tf, Uu^Ebn, Cud, Ur^Vud, Ur^Es, Uu^Em, Uu^Em, Cud, Urb, Urb, Urb, Cud, Xu, Xu, Xu, Xu
Xos, Uu^Es, Uu^Vu, Uh, Uh^Tf, Uh, Uu^Vud, Ur^Es, Xos, Xos, Xu, Xu, Xu, Xu, Xu, Xos, Xu, Xu, Xu, Xos, Xos, Ur^Es, Ur^Es, Ur^Es, Ur, Ur^Es, Ur^Es, Uu, Cud, Cud, Cud, Ur^Es, Uu, Uu^Em, Uu, Uh^Em, Uh^Emf, Xu, Urb^Ii, Xu, Xu, Xu, Uu^Em, Uu, Ur^Es, Uu^Emf, Uu^Em, Ur^Es, Uu, Uu, Ur, Uu^Es, Ur^Es, Ur, Cud, Urb, Urb, Urb^Vud, Cud, Xu, Xu, Xu
Xu, Xos, Xos, Xos, Xos, Uh^Emf, Xos, Xos, Xu, Xu, Xu, Xu, Xu, Xu, Ql, Xu, Xu, Xu, Xu, Xu, Xos, Xos, Uue^Ebn, Uu, Uu, Ur^Es, Ur^Es, Ur, Cud, 3 Kud, Cud, Ur^Es, Ur, Uu, Ur^Es, Uu^Em, Uu, Uu, Ur, Xu, Xu, Xu, Uu, Uu, Uu, Ur^Edb, Ur^Edb, Ur^Es, Ur, Ur^Edb, Ur, Ur^Edb, Ur, Urb, Urb, Urb, Urb, Cud, 2 Kud, Xu, Xu, Xu
Xu, Xu, Xu, Xu, Xu, Xu, Xu, Xu, Ql, Xu, Ql, Ql, Ql, Ql, Ql, Ql, Ql, Xu, Xu, Xu, Xu, Xos, Sm, Sm^Em, Uue^Vu, Ur, Uu^Es, Ur, Ur, Cud, Ur^Es, Ur, Uu, Ur, Uu^Ebn, Ur^Es, Ur, Ur, Urb^Ii, Xu, Xu, Xu, Uu^Tf, Uu^Em, Uu^Em, Ur^Es, Uu, Ur, Ur^Es, Ur^Edb, Ur, Ur^Es, Ur, Urb, Cud, Urb, Urb, Cud, Cud, Xu, Xu, Xu
Xu, Xu, Xu, Xu, Xu, Xu, Ql, Ql, Ql, Ql, Ql, Ql, Ql, Ql, Ur, Ql, Ql, Xu, Xu, Xu, Xu, Xu, Ss^Em, Sm^Emf, Sm^Em, Uue, Uu, Ur, Ur^Es, Ur, Ur, Uu^Em, Xu, Uu^Es, Xu, Xu, Xu, Xu, Xu, Xu, Xu, Xu, Xu, Uu, Uu, Uu^Em, Uu^Emf, Uu, Cud, Uu^Em, Ur^Es, Ur^Edb, Uu, Ur^Es, Urb, Urb, Urb, Urb^Vud, Xu, Xu, Xu, Xu
Xu, Xu, Xu, Xu, Xu, Xu, Ql, Ql, Ql, Ur, Ur^Edb, Ql, Xu, Uu^Edb, Ur^Edb, Ql, Ql, Ql, Xu, Xu, Xu, Ss^Em, Ss^Emf, Uh^Em, Sm^Es, Uue^Es, Ur, Ur^Vu, Cud, Ur^Es, Uue^Em, Uu^Vud, Sm, Sm, Xu, Xu, Xu, Xu, Xu, Xu, Xu, Xu, Xu, Xu, Xu, Xu, Xu, Uu^Ebn, Xu, Ur^Vud, Uu^Emf, Uu^Em, Uu^Emf, Cud, Ur^Es, Urb, Cud, Cud, Xu, Xu, Xu, Xu
Xu, Xu, Xu, Xu, Xu, Xu, Ql, Ql, Ql, Ur, Ur^Edb, Xu, Xuc, Ur^Edb, Ur^Pr/, Xu, Xuc, Xu, Xu, Xu, Uh^Tf, Sm^Vhs, Sm^Em, Xuc, Xuc, Rb^Es, Ur, Cud, Cud, Uu, Uue^Es, Uue^Emf, Xuc, Uh^Em, Xu, Xu, Xu, Xu, Xu, Xu, Ql, Xu, Ql, Xu, Xu, Xu, Xu, Xu, Xu, Xu, Xu, Cud, Cud, Ur^Es, Urb, Urb, Cud, Xu, Xu, Xu, Xu, Xu
Xu, Xu, Xu, Xu, Xu, Xu, Xu, Ql, Xu, Xu, Xu, Ur^Pr/, Uh^Emf, Xuc, Ur^Br|, Uh^Emf, Xuc, Xu, Uh^Em, Xu, Uue, Sm^Tf, Uue^Em, Xuc, Uu^Es, Rb^Es, Ur, Ur^Es, Rb^Es, Uu, Uue^Es, Xuc, Xuc, Sm^Emf, Uh^Tf, Xu, Xu, Xu, Xu, Ql, Ql, Ql, Ql, Ql, Xu, Xu, Ql, Xu, Xu, Xu, Xu, Xu, Xu, Urb^Ebn, Xu, Urb^Vud, Xu, Xu, Xu, Xu, Xu, Xu
Xu, Xu, Xu, Xu, Xu, Xu, Xu, Xu, Xu, Xu, Uh^Emf, Ur^Br|, Ur^Br\, Uh^Em, Ur^Br/, Uu^Emf, Uu^Em, Xu, Uh, Uue^Em, Ur^Br/, Uh^Emf, Uu^Vu, Uue^Es, Uu^Em, Uu^Vud, Rb, Ur^Es, Rb^Es, Rb, Uu^Es, Uue^Es, Sm^Es, Uue^Es, Uh^Em, Uu^Vud, Xu, Xu, Xu, Ql, Ur^Edb, Ur, Ql, Xu, Xu, Ql, Ql, Ql, Ql, Xu, Xu, Xu, Xu, Xu, Xu, Xu, Xu, Xu, Xu, Xu, Xu, Xu
Xu, Xu, Xu, Xu, Xu, Xu, Ql, Xu, Xu, Uh^Vu, Xuc, Uu^Em, Ur^Br\, Ur^Br|, Xuc, Xuc, Ur^Br/, Ur^Br\, Ur^Br/, Ur^Br/, Uue^Em, Uh, Xu, Xu, Uu^Tf, Xu, Xu, Ur^Es, Ur, Ur, Uue^Es, Xu, Sm^Es, Ss^Emf, Ss^Tf, Xu, Xu, Xu, Ql, Ql, Ur, Uu, Xu, Xu, Ql, Ql, Ur, Ql, Ql, Ql, Xu, Xu, Xu, Xu, Xu, Xu, Xu, Xu, Xu, Xu, Xu, Xu
Xu, Xu, Xu, Xu, Xu, Ql, Ql, Ql, Xu, Uh^Tf, Ur^Br/, Ur^Br/, Uu, Ur^Br\, Ur^Br/, Ur^Br/, Ur^Br|, Xuc, Ur^Br|, Uu, Uh^Em, Uh^Emf, Uh^Tf, Xu, Xu, Uu^Emf, Ur^Es, Ur, Rb^Es, Uue, Uue^Em, Sm^Em, Ss^Emf, Xu, Xu, Xu, Xu, Xu, Xu, Ql, Xu, Uu^Pr/, Uh^Vud, Xu, Xu, Ur, Ur^Edb, Ur, Ql, Ql, Xu, Xu, Xu, Xu, Xu, Xu, Xu, Xu, Xu, Xu, Xu, Xu
Xu, Xu, Xu, Xu, Ql, Ql, Ql, Ql, Ur, Ur^Pr\, Xu, Uu^Em, Xuc, Uu^Es, Uu^Es, Uu^Es, Ur^Br|, Uu^Es, Ur^Br\, Uu, Xu, Xu, Xu, Xu, Xu, Rb^Edb, Rb^Es, Ur^Es, Rb^Edb, Cud, Xu, Xu, Xu, Xu, Xu, Xu, Xu, Xu, Xu, Xu, Sm^Es, Uu^Es, Sm^Em, Uh^Emf, Uu^Em, Uu^Pr\, Xu, Ur^Edb, Ql, Xu, Xu, Xu, Xu, Xu, Xu, Xu, Xu, Xu, Xu, Xu, Xu, Xu
Xu, Xu, Xu, Xu, Ql, Ql, Ql, Ur, Uh^Emf, Ur, Xu, Uh^Emf, Uh^Tf, Xuc, Uh^Em, Uh^Vud, Ur^Br/, Uu^Em, Uu^Emf, Ur^Br\, Ur^Pr/, Xu, Ql, Xu, Xu, Cud, Sm^Edb, Ur, Ur^Es, Rb^Edb, Xu, Xu, Xu, Xu, Ur^Vu, Xu, Xu, Xu, Uh^Vud, Xu, Ss^Es, Ss, Xu, Sm^Em, Xu, Xu, Xu, Xu, Xu, Xu, Xu, Xu, Xu, Xu, Xu, Xu, Xu, Xu, Xu, Xu, Xu, Xu
Xu, Xu, Xu, Xu, Xu, Ql, Ql, Ql, Ql, Ql, Xu, Xu, Uh^Vu, Uh^Tf, Uu^Em, Ur^Br|, Xu, Xu, Xu, Xu, Ur, Ur^Edb, Ur, Ql, Xu, Xu, Ss^Em, Sm^Es, Rb, Rb^Edb, Uue^Em, Xu, Uue^Eb, Xu, Rb, Rb^Es, Sm, Sm^Emf, Uh^Emf, Uh^Tf, Xu, Xu, Xu, Xu, Xu, Xu, Xu, Xu, Xu, Xu, Xu, Xu, Xu, Xu, Xu, Xu, Xu, Xu, Xu, Xu, Xu, Xu
Xu, Xu, Xu, Xu, Xu, Xu, Ql, Ql, Ql, Ql, Xu, Xu, Xu, Xu, Xu, Ur^Pr/, Ur, Xu, Ql, Ql, Ql, Ur^Edb, Ql, Ql, Xu, Xu, Ss^Emf, Sm^Es, Sm, Rb^Edb, Ur, Uue^Emf, Ur^Es, Uu, Ur^Es, Sm^Es, Uu^Es, Sm^Bw/r, Ss, Xu, Xu, Xu, Qlf, Xu, Qlf, Qlf, Qlf, Xu, Xu, Xu, Xu, Xu, Xu, Xu, Xu, Xu, Xu, Xu, Xu, Xu, Xu, Xu
Xu, Xu, Xu, Xu, Xu, Xu, Xu, Ql, Ql, Ql, Xu, Xu, Xu, Xu, Ql, Ur, Ur^Edb, Ur, Ql, Ql, Ql, Ql, Ql, Ql, Xu, Xu, Xu, Sm^Em, Uh^Em, Uue, Rb, Ur^Edb, Rb, Ur, Cud, Cud, Cud, Sm^Edb, Ss^Edb, Xu, Xu, Qlf, Qlf, Qlf, Ur, Qlf, Qlf, Xu, Xu, Xu, Xu, Xu, Xu, Xu, Xu, Xu, Xu, Xu, Xu, Xu, Xu, Xu
Xu, Xu, Xu, Xu, Xu, Xu, Xu, Xu, Xu, Xu, Xu, Xu, Ql, Ql, Ql, Ql, Ql, Ql, Ql, Ql, Xu, Xu, Xu, Xu, Xu, Xu, Xu, Uh^Vud, Uh^Tf, Uue^Em, Uue, Rb, Sm, Rb^Es, Cud, 5 Kud, Cud, Rb^Em, Rb, Uu^Eb, Xu, Xu, Ur, Ur, Urb^Ii, Ur, Qlf, Qlf, Xu, Xu, Xu, Xu, Xu, Xu, Xu, Xu, Xu, Xu, Xu, Xu, Xu, Xu
Xu, Xu, Xu, Xu, Xu, Xu, Xu, Xu, Xu, Xu, Xu, Xu, Xu, Ql, Xu, Ql, Ql, Ql, Ql, Ql, Xu, Xu, Xu, Xu, Xu, Xu, Xu, Xu, Xu, Uh^Emf, Sm, Rb, Sm, Sm^Bw/r, Rb^Es, Cud, Uh^Em, Rb^Emf, Sm^Em, Rb, Ur, Ur^Pr\, Xu, Ur, Ur, Ur, Qlf, Qlf, Xu, Xu, Xu, Xu, Xu, Xu, Xu, Xu, Xu, Xu, Xu, Xu, Xu, Xu
Xu, Xu, Xu, Xu, Xu, Xu, Xu, Xu, Xu, Xu, Xu, Xu, Xu, Xu, Xu, Xu, Xu, Xu, Xu, Xu, Xu, Xu, Xu, Xu, Xu, Xu, Xu, Xu, Xu, Xu, Sm^Eb, Sm^Emf, Ss^Em, Ss^Em, Ss, Uue^Emf, Uh^Tf, Ss^Em, Uue^Emf, Rb^Em, Xu, Xu, Qlf, Qlf, Qlf, Qlf, Qlf, Xu, Xu, Xu, Xu, Xu, Xu, Xu, Xu, Xu, Xu, Xu, Xu, Xu, Xu, Xu
Xu, Xu, Xu, Xu, Xu, Xu, Xu, Xu, Xu, Xu, Xu, Xu, Xu, Xu, Xu, Xu, Xu, Xu, Xu, Xu, Xu, Xu, Xu, Xu, Xu, Xu, Xu, Xu, Xu, Xu, Xu, Ss^Vhs, Xu, Xu, Xu, Uue^Emf, Xu, Uh^Tf, Xu, Uu^Vud, Xu, Xu, Xu, Qlf, Xu, Qlf, Xu, Xu, Xu, Xu, Xu, Xu, Xu, Xu, Xu, Xu, Xu, Xu, Xu, Xu, Xu, Xu
Xu, Xu, Xu, Xu, Xu, Xu, Xu, Xu, Xu, Xu, Xu, Xu, Xu, Xu, Xu, Xu, Xu, Xu, Xu, Xu, Xu, Xu, Xu, Xu, Xu, Xu, Xu, Xu, Xu, Xu, Xu, Xu, Xu, Xu, Xu, Xu, Xu, Xu, Xu, Xu, Xu, Xu, Xu, Xu, Xu, Xu, Xu, Xu, Xu, Xu, Xu, Xu, Xu, Xu, Xu, Xu, Xu, Xu, Xu, Xu, Xu, Xu
