Ms, Ms, Ms, Ms, Ms, Aa, Ms, Aa, Ms, Gd, Ms, Ms, Ms, Aa^Fpa, Gll^Fp, Gll^Fp, Ms, Ms, Ms, Ms, Ms, Ms, Ms, Ms, Ms, Ms, Ms, Ms, Ms, Ms, Ms, Ms, Ms, Ms, Ms, Ms, Ms, Ms, Ms, Ms, Ms, Ms, Ms, Ms, Ms, Ms, Ms, Aa, Hhd, Hhd, Ms, Ms, Ms, Ms, Ms, Ms, Ms, Ms, Ms, Ms, Ms, Ms, Ms, Ms, Ms, Ms, Ms, Ms
Ms, Ms, Ms, Ms, Ms, Ms, Ms, Ms, Ms, Ms, Ms, Ms, Ms, Ms, Gll^Fp, Gll^Fp, Gll^Fp, Ms, Gll^Fp, Ms, Ms, Ms, Ms, Ms, Ms, Ms, Ms, Ms, Ms, Ms, Ms, Ms, Ms, Ms, Ms, Ms, Ms, Ms, Ms, Ms, Ms, Ms, Ms, Ms, Ms, Ms, Aa, Aa, Gd, Aa^Fpa, Hhd, Ms, Ms, Ms, Ms, Ms, Ms, Ms, Ms, Ms, Ms, Ms, Ms, Ms, Ms, Ms, Ms, Ms
Ms, Ms, Ms, Ms, Ms, Ms, Cfa, Ms, Ha, Ms, Aa, Ha, Ha, Hhd, Hhd, Hhd, Gll^Fp, Gll^Fp, Hhd, Re, Md, Ms, Ms, Ms, Ms, Ms, Ha, Ha, Ha, Ms, Ms, Ms, Ms, Ms, Ms, Ms, Ms, Ms, Cfa, Ms, 7 Kfa, Ms, Ha, Ms, Gd, Gd, Aa, Gd, Aa^Fpa, Aa^Fpa, Hhd, Hhd, Ms, Ms, Ms, Ms, Ms, Ms, Ms, Ms, Ms, Ms, Ms, Ms, Ms, Ms, Ms, Ms
Ms, Ms, Ms, Ms, Cfa, Player_10_start Kfa, Cfa, Cfa, Aa, Aa, Ha, Ha, Ha, Hhd, Hhd, Hhd, Ha, Ha, Re, Re, Md, Md, Md, Ms, Md, Md, Ai, Ai, Ww, Ai, Ai, Ms, Ms, Ms, Ms, Ms, Hhd, Hhd, Hhd, Cfa, Cfa, Cfa, Hhd, Gd, Hhd, Aa, Gd, Aa, Aa^Fpa, Aa^Fpa, Aa^Fpa, Hhd, Ms, Ms, Ms, Ms, Ms, Ha, Ha, Ha, Coa, Coa, 6 Koa, Ms, Ms, Ms, Ms, Ms
Ms, Ms, Ms, Cfa, Cfa, Cfa, Aa, Cfa, Aa, Aa, Aa, Ha, Ha, Ha, Hhd, Hhd, Ha, Ha, Hhd, Hhd, Hhd, Md, Md, Md, Md, Ha, Ai, Ai, Ww, Ww, Ms, Ms, Ms, Ms, Ms, Ha, Ha, Ha, Hhd, Cfa, Ha, Cfa, Hhd, Hhd, Aa^Fpa, Gd, Gd, Gd, Gd, Gd, Gd, Ha, Ms, Ms, Ms, Ms, Ha, Ha, Re, Aa^Voa, Re, Coa, Coa, Coa, Ms, Ms, Ms, Ms
Ms, Ms, Ms, Ha, Ai, Cfa, Aa, Aa, Aa, Aa, Aa, Aa, Ha, Ha, Re, Re, Hhd, Hhd, Hhd, Hhd, Md, Md, Ms, Ms, Ms, Ai, Ai, Ai, Aa^Feta, Ai, Ms, Ms, Ms, Ms, Ms, Ha, Ha, Ha, Hhd, Ha, Ms, Ms, Ms, Hhd, Re, Re, Re, Aa, Gd, Aa^Fpa, Gd, Aa^Voa, Ha, Ms, Ms, Ha, Re, Re, Ha, Re, Ha, Coa, Coa, Coa, Ms, Ms, Ms, Ms
Ms, Ms, Ha, Ha, Ai, Aa, Aa, Aa, Aa, Aa, Aa, Aa, Aa, Re, Ha, Ha, Ha, Ha, Hhd, Hhd, Md, Ms, Ms, Ms, Ms, Ms, Ms, Ha, Ha, Ha, Ms, Ms, Ms, Ms, Ms, Ms, Ms, Ha, Md, Md, Md, Ms, Hhd, Re, Hhd, Aa^Voa, Aa, Re, Re, Aa, Gd, Ha, Ha, Ms, Ms, Re, Ha, Ha, Ha, Ha, Ha, Ha, Ha, Ha, Ha, Ms, Ms, Ms
Ms, Ms, Gd, Ai, Ai, Aa, Aa, Aa, Aa, Aa, Aa, Aa, Aa, Re, Ha, Ha, Ha, Ha, Ha, Md, Md, Md, Md, Ms, Md, Ms, Ms, Ms, Md, Md, Md, Ms, Ms, Md, Md, Md, Md, Ms, Ms, Md, Md, Md, Md, Hhd, Hhd, Ha, Gd, Aa, Aa, Re, Re, Ha, Re, Ms, Re, Re, Ai, Ha, Ha, Ha, Ha, Ha, Ha, Ha, Ms, Ms, Ms, Ms
Ai, Ai, Ww, Aa^Fpa, Gd, Aa, Aa, Aa, Aa, Aa, Aa, Aa, Aa, Re, Gd, Aa, Ha, Aa^Voa, Ha, Ha, Ms, Md, Md, Md, Md, Ms, Ms, Ms, Ms, Ms, Ms, Ms, Aa^Voa, Md, Md, Md, Md, Md, Md, Md, Md, Md, Aa^Voa, Hhd, Hhd, Hhd, Aa, Aa, Aa, Aa, Aa, Re, Ha, Re, Ai, Ai, Ai, Ai, Ha, Ha, Ha, Ha, Ha, Ha, Ms, Ms, Ms, Ms
Ai, Ai, Aa^Fpa, Ai, Ai, Ww, Ai, Ai, Ai, Aa, Aa, Aa, Re, Re, Gd, Gd, Aa, Ha, Ha, Ms, Ms, Ms, Ms, Md, Ms, Ms, Ms, Ms, Ms, Ms, Ms, Ms, Ms, Md, Md, Md, Md, Md, Md, Ms, Ms, Md, Md, Md, Ha, Ha, Aa, Aa, Aa, Aa, Aa, Re, Ha, Ha, Ai, Ai, Ai, Ai, Ai, Ha, Ha, Ha, Ai, Ms, Ms, Ms, Ms, Md
Ai, Gd, Gd, Aa^Fpa, Aa^Fpa, Ww, Aa, Aa^Feta, Ai, Aa, Aa, Gd, Re, Aa^Fpa, Aa^Fpa, Gd, Aa, Aa, Ms, Ms, Ms, Ms, Ms, Ms, Ms, Ms, Ms, Ms, Ms, Ms, Ms, Ms, Ms, Md, Md, Md, Md, Md, Ms, Ms, Ms, Ms, Md, Ms, Ha, Ha, Gd, Gd, Aa^Fpa, Gd, Gd, Re, Ha, Ai, Ai, Ai, Ai, Ai, Ha, Aa, Ai, Ai, Ha, Ms, Md, Ms, Ms, Ms
Ai, Gd, Gd, Gd, Aa^Voa, Ww, Ai, Aa, Ww, Ww, Gd, Aa^Fpa, Re, Aa^Voa, Aa^Fpa, Aa^Fpa, Gd, Aa, Ha, Ms, Coa, Coa, Coa, Ms, Ms, Ms, Ms, Ms, Md, Md, Md, Md, Ms, Ms, Md, Md, Md, Md, Ms, Ms, Ms, Ms, Ms, Md, Hhd, Hhd, Aa^Fpa, Aa^Fpa, Aa^Fpa, Aa^Fpa, Aa^Fpa, Re, Aa, Aa, Ai, Ai, Ai, Ai, Ha, Hhd, Ww, Gd, Ha, Md, Md, Md, Md, Md
Ai, Ai, Gd, Gd, Gd, Ww, Aa^Fpa, Ai, Ww, Ww, Ww, Aa^Fpa, Aa^Fpa, Re, Gll^Fp, Aa^Fpa, Aa^Fpa, Gd, Ai, Ha, Coa, 8 Koa, Coa, Ms, Ms, Ms, Ms, Ms, Md, Md, Md, Md, Ms, Ms, Md, Md, Md, Ms, Ms, Ms, Ms, Ms, Ms, Md, Hhd, Hhd, Gll^Fp, Gll^Fp, Gll^Fp, Gll^Fp, Aa^Fpa, Re, Aa, Ai, Ai, Ai, Ai, Aa, Ha, Ww, Aa^Fpa, Hhd, Ww, Ai, Ai, Md, Md, Md
Ms, Gd, Ha, Aa, Aa, Ai, Ww, Ww, Ww, Ai, Ww, Aa^Fpa, Re, Re, Gll^Fp, Gll^Fp, Aa^Voa, Gd, Ai, Ai, Ai, Coa, Ww, Ms, Ms, Ms, Ms, Ms, Md, Md, Md, Md, Ms, Ms, Md, Hhd, Hhd, Ms, Ms, Ms, Ms, Ms, Ms, Ms, Hhd, Hhd, Gd, Gll^Fp, Gll^Fp, Aa^Fpa, Aa^Fpa, Re, Aa, Aa, Aa, Ai, Ai, Ai, Ww, Ww, Hhd, Aa^Fpa, Aa^Voa, Ai, Aa, Ms, Ms, Ms
Md, Ms, Ms, Ha, Aa, Ai, Aa, Aa, Gd, Ww, Aa^Fpa, Aa^Fpa, Re, Gll^Fp, Gll^Fp, Gll^Fp, Gll^Fp, Aa^Fpa, Ai, Ai, Ha, Ha, Ww, Ms, Ms, Ms, Ms, Ms, Hhd, Hhd, Hhd, Hhd, Ha, Ha, Hhd, Hhd, Hhd, Hhd, Ms, Ms, Ms, Ms, Ms, Ha, Hhd, Hhd, Hhd, Gll^Fp, Aa^Fpa, Aa^Fpa, Gd, Re, Aa, Aa, Aa, Ai, Ai, Ai, Aa^Fpa, Aa^Fpa, Hhd, Hhd, Gd, Aa, Gd, Ms, Ms, Ms
Md, Md, Ms, Ha, Ha, Ai, Aa, Aa, Aa, Aa, Gd, Gd, Re, Gll^Fp, Gll^Fp, Gd, Gll^Fp, Aa^Fpa, Ai, Ai, Aa, Ha, Ha, Ha^Vhha, Ha, Ha, Ha, Ha, Hhd, Hhd, Gd, Ha, Ha, Ha, Hhd, Aa^Voa, Hhd, Hhd, Hhd, Hhd, Ha, Ms, Ms, Ms, Hhd, Hhd, Hhd, Gll^Fp, Aa^Voa, Gd, Re, Re, Gd, Gd, Aa, Aa, Aa^Voa, Ww, Aa^Fpa, Gll^Fp, Gd, Ha, Gd, Aa, Ms, Ms, Ms, Ms
Md, Md, Ms, Ms, Ha, Ai, Aa, Aa, Aa, Aa, Aa, Aa, Re, Aa^Voa, Ww, Gll^Fp, Gll^Fp, Aa^Fpa, Ai, Aa, Aa, Ha, Ha, Ha, Ha, Ha, Ha, Aa, Aa, Aa, Aa, Aa, Aa, Gd, Aa^Fpa, Gll^Fp, Gll^Fp, Gll^Fp, Aa^Voa, Hhd, Ha, Ms, Ms, Ms, Ha, Hhd, Hhd, Aa^Fpa, Re, Re, Gd, Gd, Aa^Fpa, Gd, Aa, Aa, Aa^Fpa, Aa^Fpa, Aa^Fpa, Aa^Fpa, Gd, Aa, Ha, Aa, Aa, Ms, Ms, Ms
Ms, Ms, Ms, Ms, Ms, Ai, Ai, Aa, Aa, Aa, Aa, Aa, Aa, Re, Ww, Ww, Ww, Ww, Ww, Gd, Gd, Gd, Aa, Aa, Aa, Aa, Aa, Aa, Aa, Aa, Aa, Aa, Aa, Aa, Aa^Fpa, Gll^Fp, Gll^Fp, Gll^Fp, Hhd, Hhd, Ha, Hhd, Hhd, Hhd, Hhd, Hhd, Gll^Fp, Aa^Fpa, Re, Aa^Fpa, Aa^Fpa, Aa^Fpa, Aa^Fpa, Aa^Fpa, Aa, Aa, Gd, Aa^Fpa, Aa^Fpa, Gd, Gd, Aa, Cfa, Aa, Cfa, Ms, Ms, Ms
Ms, Ms, Ms, Ms, Ms, Aa, Aa, Ai, Gd, Gd, Ai, Ai, Ai, Ww, Re, Aa^Fpa, Gll^Fp, Ww, Ww, Gd, Gd, Gd, Gd, Aa, Aa, Aa, Aa^Fpa, Aa, Aa, Re, Re, Aa, Aa, Aa, Gd, Aa^Fpa, Gll^Fp, Gll^Fp, Hhd, Hhd, Ha, Hhd, Hhd, Hhd, Hhd, Hhd, Gd, Gll^Fp, Re, Aa^Fpa, Aa^Fpa, Aa^Fpa, Aa^Fpa, Gd, Aa, Aa, Gd, Gd, Aa^Fpa, Aa^Fpa, Gd, Gd, Re, 3 Kfa, Cfa, Aa, Ms, Ms
Md, Ms, Md, Ms, Ms, Ms, Aa, Ww, Ww, Ww, Aa, Ai, Aa, Ww, Re, Gd, Aa^Fpa, Gll^Fp, Aa^Fpa, Gd, Gd, Gd, Gd, Aa, Aa, Gd, Aa^Fpa, Aa^Fpa, Aa^Fpa, Aa^Fpa, Re, Aa, Aa, Aa, Gd, Aa^Fpa, Aa^Fpa, Gll^Fp, Aa^Fpa, Hhd, Ha, Ha, Hhd, Hhd, Hhd, Gd, Re, Re, Re, Aa^Fpa, Aa, Aa, Aa^Fpa, Gd, Aa, Aa, Aa, Aa, Re, Re, Re, Re, Aa^Voa, Cfa, Aa, Aa, Ms, Ms
Md, Md, Md, Ms, Ms, Ms, Aa, Aa^Voa, Aa, Aa, Aa^Fpa, Gd, Gd, Gd, Re, Gd, Aa^Fpa, Aa^Fpa, Aa^Fpa, Aa^Fpa, Gd, Gd, Aa^Fpa, Aa^Fpa, Aa^Fpa, Gll^Fp, Gll^Fp, Gll^Fp, Gll^Fp, Aa^Fpa, Re, Aa, Aa, Aa, Aa, Gd, Aa^Fpa, Aa^Fpa, Aa^Fpa, Ha, Ha, Ha, Hhd, Hhd, Hhd, Re, Gd, Gd, Gll^Fp, Re, Aa, Aa, Re, Re, Re, Re, Re, Re, Aa, Aa, Aa, Re, Re, Aa, Aa, Ms, Ms, Ms
Md, Md, Ms, Ms, Ms, Ms, Ha, Aa, Aa, Aa, Re, Re, Re, Re, Re, Gd, Aa^Fpa, Aa^Fpa, Aa^Fpa, Aa^Fpa, Aa^Fpa, Aa^Fpa, Gd, Aa^Fpa, Gll^Fp, Gd, Cvr, Gd, Gll^Fp, Gll^Fp, Re, Aa, Aa, Aa, Aa, Aa, Aa, Gd, Aa, Ha, Ha, Ha, Ha, Hhd, Hhd, Re, Gd, Gll^Fp, Gll^Fp, Aa^Fpa, Aa^Fpa, Aa^Fpa, Aa^Fpa, Aa^Voa, Ww, Ai, Ai, Ai, Ai, Aa, Aa, Aa, Re, Aa, Aa, Ms, Ms, Ms
Ms, Ms, Ms, Ms, Ha, Ha, Aa, Aa, Gd, Aa^Fpa, Gll^Fp, Gll^Fp, Aa^Fpa, Aa^Fpa, Re, Gd, Aa^Fpa, Aa^Voa, Aa^Fpa, Gd, Gd, Gd, Gd, Aa^Fpa, Gll^Fp, Gll^Feth, Kvr, Cvr, Gll^Fp, Aa^Fpa, Re, Aa, Aa, Aa, Aa, Aa, Aa, Aa, Aa, Ha, Ha, Ha, Ha, Hhd, Re, Re, Gll^Fp, Gll^Fp, Aa^Fpa, Gd, Gd, Aa^Fpa, Aa^Fpa, Gd, Ai, Ai, Ai, Ai, Aa, Ai, Ai, Aa, Aa, Re, Ms, Ms, Ms, Ms
Ms, Ms, Ms, Ms, Cfa, Aa, Aa, Aa, Gd, Aa^Fpa, Ww, Gll^Fp, Gll^Fp, Aa^Voa, Re, Gd, Aa^Fpa, Aa^Fpa, Aa^Fpa, Gd, Aa, Gd, Aa^Fpa, Aa^Fpa, Gll^Fp, Cvr, Gd, Gd, Gll^Fp, Aa^Fpa, Aa, Re, Re, Aa, Aa, Aa, Aa, Aa, Aa, Aa, Aa, Ha, Ha, Hhd, Re, Aa^Fpa, Aa^Voa, Aa^Fpa, Aa, Gd, Gd, Aa^Fpa, Aa^Fpa, Gd, Aa, Ai, Ai, Ai, Ai, Aa, Ai, Aa, Aa, Re, Ms, Ms, Ms, Ms
Ms, Ms, Ms, Ms, 5 Kfa, Cfa, Aa, Aa, Aa, Ww, Ww, Ww, Ww, Aa^Fpa, Aa, Re, Re, Gd, Gd, Gd, Aa, Aa, Gd, Aa^Fpa, Gll^Fp, Gd, Gll^Fp, Gll^Fp, Aa^Fpa, Aa^Fpa, Aa, Aa, Re, Aa, Aa, Gd, Gd, Aa, Aa, Aa, Aa, Aa, Re, Re, Gd, Aa^Fpa, Aa^Fpa, Gd, Aa, Aa, Gd, Gd, Gd, Gd, Gd, Ai, Aa, Ai, Ai, Ai, Ai, Ai, Aa, Ms, Ms, Ms, Ms, Ms
Ms, Ms, Ms, Cfa, Cfa, Cfa, Aa, Aa, Ai, Ww, Ww, Ww, Ww, Ww, Aa, Aa, Aa, Re, Re, Aa, Aa, Aa, Aa, Gd, Aa^Fpa, Aa^Voa, Aa^Fpa, Gd, Gd, Aa, Aa, Aa, Aa^Voa, Re, Aa, Gd, Gd, Gd, Gd, Aa^Voa, Re, Re, Aa, Gd, Aa^Fpa, Gll^Fp, Aa^Fpa, Aa, Aa, Aa, Aa, Aa, Gd, Gd, Aa, Ai, Ai, Aa, Aa, Aa, Ai, Ai, Aa, Ms, Ms, Ms, Ms, Ms
Ms, Ms, Ha, Ai, Ai, Aa, Ai, Aa, Ai, Aa, Ww, Ww, Ww, Ai, Aa, Aa, Aa, Aa, Re, Aa, Aa, Aa, Aa, Gd, Gd, Aa^Fpa, Aa, Aa, Aa, Aa, Aa, Aa, Aa, Re, Re, Gd, Gd, Aa^Fpa, Re, Re, Aa, Aa, Gd, Gd, Aa^Fpa, Ww, Aa^Fpa, Aa, Aa, Aa, Aa, Aa, Aa, Aa, Aa, Aa, Ai, Aa, Ai, Ai, Ai, Aa, Aa, Ms, Ms, Ms, Ms, Ms
Ms, Ms, Ms, Ha, Ai, Ai, Ai, Ai, Aa, Aa, Ww, Ww, Ww, Ai, Aa, Aa, Aa, Aa, Re, Aa, Aa, Aa, Aa, Aa, Aa, Aa, Re, Aa, Re, Re, Re, Aa, Re, Aa, Re, Re, Re, Re, Gd, Gd, Aa, Gd, Ww, Gd, Ww, Ww, Ww, Aa, Aa, Aa, Aa, Aa, Aa, Aa, Ai, Ai, Ai, Ai, Ai, Ai, Aa, Aa, Aa^Voa, Aa, Ai, Ms, Ms, Ms
Ms, Ms, Ms, Ha, Ha, Ai, Aa, Ai, Aa, Aa, Ww, Ww, Gd, Gd, Ai, Ai, Aa, Aa, Re, Aa, Aa, Aa, Aa, Aa, Re, Re, Aa, Re, Aa, Aa, Aa, Re, Aa, Re, Aa, Aa, Aa, Re, Re, Gd, Gd, Gd, Ww, Ww, Ai, Ai, Ai, Ha, Aa, Aa, Aa, Aa, Aa^Voa, Aa, Ai, Aa, Ai, Ai, Ai, Ai, Ai, Aa, Aa, Aa, Ai, Ms, Ms, Ms
Ms, Ms, Ms, Ms, Ms, Ai, Ai, Ai, Aa, Ai, Ww, Ww, Ww, Ww, Aa, Ai, Ww, Gd, Re, Gd, Aa, Aa, Re, Re, Gd, Gd, Gd, Aa, Aa, Aa, Aa, Aa, Aa, Aa, Aa, Aa, Aa, Aa, Re, Aa, Aa, Aa, Gd, Ai, Ai, Ai, Ai, Aa, Aa, Aa, Aa, Aa, Aa, Aa, Aa, Ai, Aa, Aa, Ai, Ai, Aa, Ai, Ai, Ai, Ai, Ms, Ms, Ms
Ms, Ms, Ms, Ms, Aa, Aa, Ai, Ai, Ai, Aa, Ww, Ww, Ww, Ww, Ww, Ai, Gd, Aa^Fpa, Aa^Fpa, Re, Re, Re, Gd, Aa^Voa, Gd, Aa^Fpa, Gd, Gd, Aa, Aa, Aa, Aa, Aa, Aa, Aa, Aa, Aa, Aa, Re, Aa, Aa, Gd, Aa^Fpa, Ww, Ai, Ai, Ai, Ha, Aa, Aa, Gd, Gd, Gd, Aa, Aa, Aa, Aa, Aa, Ai, Aa, Ai, Ai, Aa, Aa, Ms, Ms, Ms, Ms
Ms, Ms, Ms, Ms, Aa, Gd, Ww, Ww, Ai, Ai, Ai, Ww, Ww, Ww, Ww, Ai, Gd, Gd, Aa^Voa, Re, Ha, Aa, Ha, Hhd, Ha, Hhd, Hhd, Aa, Aa, Aa, Aa, Aa, Aa, Aa, Aa, Aa, Aa, Aa, Re, Aa, Aa, Gd, Aa^Fpa, Ww, Ww, Ww, Aa^Voa, Aa, Aa, Aa, Gd, Aa^Fpa, Gd, Aa, Aa, Aa, Ai, Aa, Ai, Ww, Ai, Ai, Ai, Aa, Ms, Ms, Ms, Ms
Ms, Ms, Ms, Ha, Gd, Aa^Fpa, Aa^Fpa, Ww, Ww, Ai, Ai, Ww, Ww, Ww, Gd, Ai, Gd, Aa, Re, Re, Ha, Ha, Ha, Hhd, Ms, Ms, Ms, Ha, Aa, Aa, Aa, Gd, Gd, Aa^Fpa, Gd, Aa, Aa, Aa, Re, Aa, Aa, Aa^Fpa, Aa^Fpa, Gll^Fp, Gll^Fp, Ww, Ww, Ww, Ai, Aa, Aa, Aa, Gd, Aa, Aa, Ai, Ai, Ai, Ww, Gd, Gd, Ai, Aa, Ai, Ms, Ms, Ms, Ms
Ms, Ms, Ms, Ha, Aa^Fpa, Aa^Fpa, Aa^Fpa, Aa^Fpa, Gd, Aa, Ai, Ww, Ww, Aa^Voa, Aa, Aa, Aa, Re, Aa, Ha, Ha, Ha, Ms, Ms, Ms, Ms, Ms, Ha, Ha, Aa, Gd, Aa^Fpa, Aa^Voa, Aa^Fpa, Gd, Aa, Aa, Aa, Re, Aa, Gd, Aa^Fpa, Gll^Fp, Gll^Fp, Gll^Fp, Hhd, Ww, Ww, Ww, Aa, Ai, Aa, Aa, Aa, Ai, Ai, Gd, Aa^Fpa, Aa^Fpa, Gd, Gd, Aa, Aa, Aa, Ms, Ms, Ms, Ms
Ms, Ms, Ms, Ms, Aa^Fpa, Ww, Ww, Aa^Fpa, Gd, Aa, Aa, Ai, Ai, Ai, Aa, Aa, Aa, Re, Gd, Ha, Hhd, Ms, Ms, Ms, Ms, Ms, Ms, Ha, Ha, Aa, Aa^Fpa, Aa^Fpa, Aa^Fpa, Aa^Fpa, Aa^Fpa, Aa, Aa, Re, Aa, Re, Aa^Voa, Aa^Fpa, Gll^Fp, Gll^Fp, Gll^Fp, Ww, Ww, Ww, Gd, Ai, Gd, Ai, Ai, Ai, Ai, Ai, Gd, Aa^Fpa, Aa^Fpa, Gd, Gd, Aa, Coa, Coa, 4 Koa, Ms, Ms, Ms
Ms, Ms, Ms, Ms, Coa, Ww, Ww, Ww, Aa, Aa, Aa, Aa, Ai, Ai, Ai, Aa, Aa, Re, Ha, Hhd, Hhd, Hhd, Ha, Ms, Ms, Ms, Ha, Ha, Ha, Gd, Aa^Fpa, Aa^Fpa, Aa^Fpa, Aa^Fpa, Gd, Aa, Re, Re, 2 Gd, Re, Re, Gd, Aa^Fpa, Gll^Fp, Aa^Fpa, Ww, Aa^Fpa, Gd, Gd, Gd, Aa, Aa, Aa, Ai, Aa, Aa, Gd, Gd, Aa^Voa, Aa^Fpa, Gd, Aa, Aa, Coa, Coa, Ms, Ms, Ms
Ms, Ms, Ms, Ms, 9 Koa, Coa, Aa^Voa, Ww, Aa, Aa, Aa, Gd, Ww, Ww, Ww, Gd, Gd, Re, Hhd, Hhd, Hhd, Ms, Ms, Ms, Ha, Ha, Aa^Voa, Ha, Ha, Aa, Gd, Aa^Fpa, Aa^Fpa, Aa^Fpa, Gd, Aa, Re, Gd, Gd, Gd, Re, Aa, Gd, Aa^Fpa, Aa^Fpa, Aa^Fpa, Aa^Fpa, Gd, Gd, Aa, Gd, Aa, Aa, Aa, Re, Re, Re, Gd, Gd, Aa^Fpa, Gd, Gd, Re, Coa, Ms, Ms, Ms, Ms
Ms, Ms, Ms, Coa, Coa, Coa, Ww, Ai, Aa, Aa, Ai, Ww, Ai, Ai, Aa, Gd, Re, Re, Hhd, Hhd, Ha, Ms, Ms, Ms, Ms, Ha, Ha, Ha, Ha, Aa, Gd, Gd, Aa^Fpa, Aa^Fpa, Aa, Gd, Re, Aa^Fpa, Aa^Fpa, Gd, Aa, Re, Re, Re, Re, Aa^Voa, Aa^Fpa, Aa^Fpa, Gd, Aa, Gd, Gd, Aa, Re, Aa, Aa, Gd, Re, Re, Re, Re, Re, Ha, Ms, Ms, Ms, Ms, Ms
Ms, Ms, Ms, Coa, Coa, Ww, Coa, Ai, Ai, Ww, Ww, Ww, Gll^Fp, Aa, Aa, Aa^Fpa, Re, Gd, Ha, Ha, Ms, Ms, Ms, Ms, Ms, Ha, Ha, Ha, Aa, Aa, Gd, Gd, Aa, Aa, Aa, Aa, Re, Aa^Fpa, Aa^Voa, Aa^Fpa, Gd, Aa, Aa, Aa, Aa, Re, Aa^Fpa, Gd, Aa, Aa, Gd, Aa, Re, Re, Aa, Aa, Aa, Aa^Fpa, Gd, Gd, Gd, Gd, Ms, Ms, Ms, Ms, Ms, Ms
Ms, Ms, Ms, Ms, Coa, Coa, Coa, Gd, Ai, Ww, Aa^Voa, Gll^Fp, Gll^Fp, Aa, Aa, Re, Gd, Aa, Ha, Ha, Ha, Ms, Ms, Ms, Ha, Ha, Ha, Aa, Aa, Gd, Gd, Gd, Gd, Aa, Aa, Aa, Gd, Aa^Fpa, Aa^Fpa, Aa^Fpa, Aa^Fpa, Aa, Aa, Ha, Ha, Re, Re, Re, Re, Re, Re, Re, Aa, Aa^Voa, Aa^Fpa, Aa, Aa^Fpa, Gll^Fp, Aa^Fpa, Aa^Fpa, Aa^Fpa, Gd, Ms, Ms, Ms, Ms, Ms, Ms
Ms, Ms, Ms, Ms, Ms, Aa^Fpa, Aa^Fpa, Gd, Aa, Gd, Aa^Fpa, Gll^Fp, Aa^Fpa, Aa^Fpa, Re, Gd, Aa, Aa, Ha, Aa^Voa, Ha, Ms, Ms, Ms, Ha, Ha, Aa, Aa, Aa, Gd, Gd, Aa^Fpa, Aa^Voa, Aa^Fpa, Gd, Re, Cea, Gd, Aa^Fpa, Aa^Fpa, Gd, Aa, Aa, Ha, Ha, Gd, Gd, Gd, Aa^Fpa, Aa^Fpa, Gd, Aa, Aa^Fpa, Aa^Fpa, Gll^Fp, Aa^Fpa, Gd, Gd, Hhd, Aa^Fpa, Gd, Aa, Ms, Ms, Ms, Ms, Ms, Ms
Ms, Ms, Ms, Ms, Ms, Ms, Ms, Ha, Ha, Gd, Ha, Gd, Re, Re, Aa, Aa, Aa, Aa, Ha, Ha, Ha, Ha, Ha, Ha, Ha, Aa, Aa, Aa, Aa, Gd, Aa^Fpa, Aa^Fpa, Gll^Fp, Aa^Fpa, Gd, Cea, 1 Kea, Re^Vct, Gd, Gd, Gd, Ha, Ha, Hhd, Ha, Ha, Gd, Aa^Fpa, Aa^Fpa, Gll^Fp, Aa^Fpa, Aa^Fpa, Aa^Fpa, Gll^Fp, Gll^Fp, Hhd, Hhd, Hhd, Hhd, Hhd, Ms, Ms, Ms, Ms, Ms, Ms, Ms, Ms
Ms, Ms, Ms, Ms, Ms, Ms, Ms, Ms, Ms, Ha, Ms, Ha, Ms, Ha, Ha, Aa, Aa, Ha, Ms, Ha, Ha, Ha, Ha, Ha, Aa, Aa, Aa, Aa, Aa, Gd, Aa^Fpa, Gll^Fp, Aa^Fpa, Gd, Re, Re^Vct, Cea, Cea, Aa^Fpa, Aa^Fpa, Hhd, Ha, Ha, Hhd, Hhd, Hhd, Hhd, Aa^Fpa, Gll^Fp, Gll^Fp, Gll^Fp, Aa^Fpa, Hhd, Gll^Fp, Hhd, Hhd, Hhd, Hhd, Hhd, Hhd, Ms, Ms, Ms, Ms, Ms, Ms, Ms, Ms
Ms, Ms, Ms, Ms, Ms, Ms, Ms, Ms, Ms, Ms, Ms, Ms, Ms, Ms, Ms, Ms, Ms, Ms, Ms, Ha, Ha, Ha, Ha, Aa, Aa, Aa, Aa, Aa, Aa, Aa, Re, Aa^Fpa, Aa^Fpa, Re, Aa, Aa, Aa, Gd, Aa^Fpa, Gd, Ha, Ha, Ha, Hhd, Ha, Ha, Hhd, Hhd, Hhd, Hhd, Hhd, Hhd, Hhd, Hhd, Hhd, Hhd, Hhd, Hhd, Ms, Ms, Ms, Ms, Ms, Ms, Ms, Ms, Ms, Ms
Ms, Ms, Ms, Ms, Ms, Ms, Ms, Ms, Ms, Ms, Ms, Ms, Ms, Ms, Ms, Ms, Ha, Ms, Ha, Ms, Hhd, Aa^Fpa, Gd, Aa, Aa, Aa, Aa, Aa, Aa, Re, Aa, Re, Re, Re, Aa, Aa, Aa, Aa, Aa, Aa, Ha, Aa, Ha, Ha, Ha, Ha, Hhd, Hhd, Hhd, Hhd, Hhd, Hhd, Hhd, Hhd, Hhd, Hhd, Hhd, Ms, Ms, Ms, Ms, Ms, Ms, Ms, Ms, Ms, Ms, Ms
