Ms^Xm, Ms^Xm, Ms^Xm, Ms^Xm, Ms^Xm, Ms^Xm, Ms^Xm, Ms^Xm, Ms^Xm, Ms^Xm, Ms^Xm, Mm, Ms^Xm, Ms^Xm, Ms^Xm, Ms^Xm, Ms^Xm, Gg, Ms^Xm, Mm, Ms^Xm, Gg, Ms^Xm, Ms^Xm, Ms^Xm, Gg, Ms^Xm, Ms^Xm, Ms^Xm, Ms^Xm, Ms^Xm, Ms^Xm, Ms^Xm, Ms^Xm, Ms^Xm
Ms^Xm, Ms^Xm, Ms^Xm, Ms^Xm, Ms^Xm, Ms^Xm, Ms^Xm, Ms^Xm, Ms^Xm, Ms^Xm, Ms^Xm, Ms^Xm, Ms^Xm, Ms^Xm, Ms^Xm, Ms^Xm, Ms^Xm, Ms^Xm, Ms^Xm, Ms^Xm, Ms^Xm, Ms^Xm, Ms^Xm, Ms^Xm, Ms^Xm, Ms^Xm, Ms^Xm, Ms^Xm, Ms^Xm, Ms^Xm, Ms^Xm, Ms^Xm, Ms^Xm, Ms^Xm, Ms^Xm
Ms^Xm, Ms^Xm, Ms^Xm, Ms^Xm, Ms^Xm, Ms^Xm, Ms^Xm, Ms^Xm, Ms^Xm, Ms^Xm, Ms^Xm, Ms^Xm, Ms, Ms^Xm, Ms^Xm, Ms^Xm, Ms, Ms^Xm, Ms, Ms^Xm, Ms, Ms^Xm, Ms, Ms^Xm, Ms^Xm, Ms^Xm, Ms^Xm, Ms^Xm, Ms^Xm, Ms^Xm, Ms^Xm, Ms^Xm, Ms^Xm, Ms^Xm, Ms^Xm
Ms^Xm, Ms^Xm, Ms^Xm, Ms^Xm, Ms^Xm, Ms^Xm, Ms^Xm, Ms^Xm, Ms, Ms, Ms, Ms, Cfa, Ms, Ms, Ms, Ms, Ms, Ms, Ms, Ms, Ms, Ms, Ms, Ms, Ms, Ms, Ms^Xm, Ms^Xm, Ms^Xm, Ms^Xm, Ms^Xm, Ms^Xm, Ms^Xm, Ms^Xm
Ms^Xm, Ms^Xm, Ms^Xm, Ms^Xm, Ms^Xm, Ms^Xm, Ms^Xm, Ms, Ms, Ms, Ms, Cfa, Player_10_start Kfa, Cfa, Cfa, Ms, Ha, Ha, Aa^Fpa, Aa^Voa, Aa^Fma, Ms, Ms, Ms, Ms, Ms, Ms, Ms^Xm, Ms^Xm, Ms^Xm, Ms^Xm, Ms^Xm, Ms^Xm, Ms^Xm, Ms^Xm
Ms^Xm, Ms^Xm, Ms^Xm, Ms^Xm, Ms^Xm, Ms^Xm, Ms, Ms, Ms, Ms, Ms, Cfa, Cfa, Cfa, Cfa, Aa^Voa, Ha, Ha, Ha, Aa, Ha, Ha, Aa, Aa, Aa, Ms, Ms, Ms, Ms^Xm, Ms^Xm, Ms^Xm, Ms^Xm, Ms^Xm, Ms^Xm, Ms^Xm
Ms^Xm, Ms^Xm, Ms^Xm, Ms^Xm, Ms^Xm, Ms, Ms, Ms, Ms, Ms, Ms, Cfa, Cfa, Aa^Fda, Aa, Aa, Aa^Fpa, Aa, Aa, Aa, Aa, Ha, Aa, Aa^Voa, Aa, Ms, Ms, Ms, Ms, Ms^Xm, Ms^Xm, Ms^Xm, Ms^Xm, Ms^Xm, Ms^Xm
Ms^Xm, Ms^Xm, Ms^Xm, Ms^Xm, Ms^Xm, Ms, Ms, Ms, Ms, Ms, Aa^Voa, Ha, Aa^Fpa, Aa, Aa, Aa, Ha, Ha, Ha, Aa, Aa, Aa^Fda, Aa, Aa^Fda, Aa, Ha, Coa, Aa^Voa, Aa^Fma, Ms, Ms, Ms^Xm, Ms^Xm, Ms^Xm, Ms^Xm
Ms^Xm, Ms^Xm, Ms^Xm, Ms^Xm, Ms, Ms, Ms, Ms, Aa^Fda, Ha, Aa^Fma, Aa^Fma, Aa, Aa^Fda, Aa^Fma, Aa, Aa, Ha, Aa, Aa^Voa, Aa, Aa, Ha, Aa, Aa, Aa, Aa^Fma, Aa^Fpa, Aa, Ms, Ms, Ms, Ms^Xm, Ms^Xm, Ms^Xm
Ms^Xm, Ms^Xm, Ms^Xm, Ms^Xm, Ms, Ms, Ms, Aa^Voa, Aa, Aa, Aa^Fda, Ha, Ha, Aa, Aa, Aa^Voa, Aa, Aa, Ha, Ha, Ha, Aa^Fda, Aa, Coa, Aa, Aa^Fma, Aa^Fpa, Aa^Fda, Ha, Ms, Ms, Ms, Ms, Ms^Xm, Ms^Xm
Ms^Xm, Ms^Xm, Ms^Xm, Ms^Xm, Ms, Ms, Ms, Aa^Fpa, Aa, Aa^Fda, Aa, Aa, Aa, Aa, Aa, Aa, Aa, Aa, Aa, Ha, Aa^Fma, Aa, Aa, Aa, Aa^Fpa, Aa, Aa, Aa^Fda, Aa^Voa, Ms, Ms, Ms, Ms, Ms^Xm, Ms^Xm
Ms^Xm, Ms^Xm, Ms^Xm, Ms^Xm, Ms^Xm, Ms, Ms, Aa^Fpa, Aa, Aa, Aa, Ha, Ha, Aa^Fma, Aa, Aa, Aa^Fma, Aa^Voa, Aa, Aa, Ha, Aa, Coa, Aa, Aa^Voa, Aa, Coa, Coa, Coa, Aa^Fpa, Ms, Ms, Ms, Ms^Xm, Ms^Xm
Ms^Xm, Ms^Xm, Ms^Xm, Ms^Xm, Ms^Xm, Ms, Aa, Aa, Coa, Aa^Fda, Aa, Coa, Aa, Aa^Fpa, Aa^Feta, Ha, Ha, Ha, Aa, Aa^Fpa, Aa^Voa, Aa^Fda, Ha, Aa^Fpa, Ha, Aa^Fma, Coa, 9 Koa, Aa^Fma, Aa^Fpa, Ms, Ms, Ms, Ms^Xm, Ms^Xm
Ms^Xm, Ms^Xm, Ms^Xm, Ms^Xm, Ms^Xm, Ms, Aa, Aa^Voa, Aa, Aa, Aa, Aa, Aa^Voa, Aa, Ha, Aa, Aa^Fma, Aa^Fma, Ms, Ms, Ms, Aa^Fpa, Ms, Aa^Fpa, Aa, Ha, Ms, Coa, Ms, Ms, Ms, Ms, Ms, Ms^Xm, Ms^Xm
Ms^Xm, Ms^Xm, Ms^Xm, Ms^Xm, Ms, Ms, Aa^Fma, Aa, Aa^Fpa, Aa, Ha, Aa, Aa, Aa, Coa, Aa, Aa^Fpa, Ms, Ms^Xm, Ms^Xm, Ms^Xm, Ms, Ms^Xm, Ms, Ms, Ms, Ms, Ms, Ms, Ms, Ms, Ms, Ms^Xm, Ms^Xm, Ms^Xm
Ms^Xm, Ms^Xm, Ms^Xm, Ms, Ms, Ms, Aa, Aa^Fda, Aa, Aa, Coa, Coa, Coa, Ha, Aa, Ha, Aa, Ms, Ms, Ms^Xm, Ms, Ms^Xm, Ms^Xm, Ms^Xm, Ms^Xm, Ms^Xm, Ms^Xm, Ms, Ms^Xm, Ms^Xm, Ms^Xm, Ms^Xm, Ms^Xm, Ms^Xm, Ms^Xm
Ms^Xm, Ms^Xm, Ms^Xm, Ms, Ms, Ha, Aa, Aa, Ha, Aa, Coa, 8 Koa, Coa, Aa, Aa, Ha, Aa, Ha, Aa^Fda, Ms, Aa, Ms, Ms, Ms^Xm, Ms, Ms^Xm, Ms^Xm, Ms^Xm, Ms^Xm, Ms^Xm, Ms^Xm, Ms^Xm, Ms^Xm, Ms^Xm, Ms^Xm
Ms^Xm, Ms^Xm, Ms^Xm, Ms, Ms, Ha, Aa^Voa, Aa^Fma, Coa, Aa^Fda, Aa, Coa, Ha, Aa^Fda, Aa, Aa^Fma, Aa, Aa^Fma, Aa^Voa, Aa, Aa, Ha, Ms, Ms, Ms, Ms, Ms, Ms^Xm, Ms, Ms^Xm, Ms^Xm, Ms^Xm, Ms^Xm, Ms^Xm, Ms^Xm
Ms^Xm, Ms^Xm, Ms^Xm, Ms, Ms, Aa, Aa, Aa, Aa, Aa, Ha, Aa, Aa, Aa, Ha, Aa^Fpa, Ha, Aa^Fda, Aa, Aa, Aa, Ha, Aa, Ms, Aa, Ms, Ms, Ms, Ms, Ms, Ms, Ms^Xm, Ms^Xm, Ms^Xm, Ms^Xm
Ms^Xm, Ms^Xm, Ms^Xm, Ms^Xm, Ms, Ms, Ms, Aa, Aa, Aa, Aa, Aa^Fpa, Aa, Coa, Aa, Aa, Aa, Ha, Aa, Ha, Aa, Aa, Aa^Fma, Aa, Aa, Aa, Aa^Fpa, Ms, Ms, Ms, Ms, Ms, Ms^Xm, Ms^Xm, Ms^Xm
Ms^Xm, Ms^Xm, Ms^Xm, Ms^Xm, Ms^Xm, Ms, Ms, Ms, Ms, Ha, Ha, Ha, Aa, Ha, Aa, Aa^Feta, Aa, Aa^Fda, Ms, Aa^Fpa, Ms, Aa^Fma, Aa^Fpa, Ha, Aa, Aa, Aa, Ha, Aa^Voa, Ms, Ms, Ms, Ms^Xm, Ms^Xm, Ms^Xm
Ms^Xm, Ms^Xm, Ms^Xm, Ms^Xm, Ms^Xm, Ms, Ms, Ms, Ms, Aa^Voa, Aa, Aa, Ms, Aa^Fma, Ms, Ha, Ms, Ms, Ms, Ms, Ms, Ha, Ha, Aa, Aa^Feta, Aa, Ha, Ha, Aa^Fpa, Aa^Fma, Ms, Ms, Ms, Ms^Xm, Ms^Xm
Ms^Xm, Ms^Xm, Ms^Xm, Ms^Xm, Ms^Xm, Ms, Ms^Xm, Ms, Ms, Ms, Ms, Ms, Ms, Ms, Ms, Ms, Ms, Ms, Ms, Ms, Ha, Aa, Aa^Fma, Aa^Voa, Aa, Aa, Aa^Fda, Ha, Cfa, Cfa, Cfa, Ms, Ms, Ms^Xm, Ms^Xm
Ms^Xm, Ms^Xm, Ms^Xm, Ms^Xm, Ms^Xm, Ms^Xm, Ms^Xm, Ms^Xm, Ms^Xm, Ms^Xm, Ms^Xm, Ms^Xm, Ms^Xm, Ms^Xm, Ms^Xm, Ms^Xm, Ms^Xm, Ms^Xm, Ms^Xm, Ms, Ms, Aa, Ha, Ha, Aa^Fpa, Aa, Aa^Fpa, Aa, Cfa, 7 Kfa, Cfa, Ms, Ms, Ms^Xm, Mm
Ms^Xm, Ms^Xm, Ms^Xm, Ms^Xm, Ms^Xm, Ms^Xm, Ms^Xm, Ms^Xm, Ms^Xm, Ms^Xm, Ms^Xm, Ms^Xm, Ms, Ms^Xm, Ms^Xm, Ms^Xm, Ms, Ms^Xm, Ms, Ms, Ms, Aa, Ha, Ha, Aa^Fda, Aa, Aa, Aa, Aa^Fpa, Cfa, Aa^Voa, Ms, Ms, Ms^Xm, Ms^Xm
Ms^Xm, Ms^Xm, Ms^Xm, Ms^Xm, Ms^Xm, Ms^Xm, Ms^Xm, Ms^Xm, Ms^Xm, Ms^Xm, Ms, Ms, Ms, Ms, Ms, Ms, Ms, Ms, Ms, Ms, Ha, Aa, Aa^Fda, Aa, Aa^Fpa, Aa, Aa, Aa^Fda, Aa, Ha, Aa^Fma, Ms, Ms, Ms^Xm, Ms^Xm
Ms^Xm, Ms^Xm, Ms^Xm, Ms^Xm, Ms^Xm, Ms^Xm, Ms, Ms, Ms, Ms, Ms, Ms, Aa, Aa, Aa, Aa, Aa^Fma, Ms, Ms, Ms, Aa^Fpa, Aa, Aa, Aa^Fpa, Ha, Aa, Aa^Voa, Aa^Fma, Ha, Ha, Ms, Ms, Ms, Ms^Xm, Ms^Xm
Ms^Xm, Ms^Xm, Ms^Xm, Ms^Xm, Ms^Xm, Ms^Xm, Ms, Ms, Ms, Ms, Aa^Fma, Aa^Fda, Aa, Aa^Fda, Aa^Fpa, Aa^Voa, Aa, Aa, Aa^Fma, Aa, Aa, Aa, Aa, Ha, Ha, Aa, Aa, Aa, Aa^Fpa, Aa, Ms, Ms, Ms, Ms^Xm, Ms^Xm
Ms^Xm, Ms^Xm, Ms^Xm, Ms^Xm, Ms, Ms, Ms, Ms, Ha, Aa^Voa, Aa^Fda, Ha, Aa^Fpa, Aa, Aa^Fpa, Aa, Aa, Ha, Aa, Ha, Aa, Aa^Fda, Aa, Aa^Voa, Aa^Fpa, Ha, Ms, Ms, Ms, Ms, Ms, Ms, Ms^Xm, Ms^Xm, Ms^Xm
Ms^Xm, Ms^Xm, Ms^Xm, Ms^Xm, Ms, Ms, Ms, Ms, Aa, Aa, Ha, Ha, Aa, Aa^Feta, Aa, Aa^Fpa, Ha, Aa, Aa, Aa, Aa, Aa, Ms, Aa, Ms, Ms, Ms, Ms, Ms, Ms, Ms, Ms, Ms^Xm, Ms^Xm, Ms^Xm
Ms^Xm, Ms^Xm, Ms^Xm, Ms, Ms, Ms, Aa^Fpa, Aa, Ha, Ha, Aa^Fda, Aa, Ha, Aa, Aa^Fda, Ha, Aa, Aa, Aa^Fpa, Aa^Fma, Ms, Ms, Ms, Ms, Ms, Ms, Ms, Ms, Ms, Ms, Ms^Xm, Ms, Ms^Xm, Ms^Xm, Ms^Xm
Ms^Xm, Ms^Xm, Ms, Ms, Ms, Aa, Aa, Aa, Ha, Ha, Aa, Aa, Aa, Aa^Voa, Coa, Aa^Fpa, Ms, Ms, Ms, Ms, Ms, Ms^Xm, Ms^Xm, Ms, Ms^Xm, Ms^Xm, Ms^Xm, Ms^Xm, Ms^Xm, Ms^Xm, Ms^Xm, Ms^Xm, Ms^Xm, Ms^Xm, Ms^Xm
Ms^Xm, Ms^Xm, Ms, Ms, Ms, Aa^Voa, Aa, Aa, Ha, Aa, Aa, Aa^Fda, Aa, Aa^Fpa, Aa^Fma, Coa, 6 Koa, Ms, Ms, Ms, Ms, Ms, Ms, Ms^Xm, Ms, Ms^Xm, Ms, Ms^Xm, Ms^Xm, Ms^Xm, Ms^Xm, Ms^Xm, Ms^Xm, Ms^Xm, Ms^Xm
Ms^Xm, Ms^Xm, Ms^Xm, Ms, Ms, Ha, Aa, Aa, Aa^Fpa, Ha, Aa, Aa, Ha, Aa, Aa^Voa, Ha, Coa, Ms, Ms, Ms, Aa^Fpa, Ms, Ms, Ms, Ms, Ms, Ms, Ms, Ms, Ms^Xm, Ms, Ms^Xm, Ms^Xm, Ms^Xm, Mm
Ms^Xm, Ms^Xm, Ms^Xm, Ms, Ms, Cfa, Aa^Fma, Ha, Aa, Aa, Aa, Ha, Aa, Aa^Fpa, Aa, Coa, Aa^Fpa, Coa, Aa^Fpa, Ms, Aa, Aa, Aa, Ms, Aa, Ha, Ms, Ms, Ms, Ms, Ms, Ms, Ms^Xm, Ms^Xm, Ms^Xm
Ms^Xm, Ms^Xm, Ms, Ms, 5 Kfa, Cfa, Ha, Aa^Voa, Aa, Aa, Aa, Aa, Ha, Aa, Aa, Ha, Ha, Coa, Ha, Aa, Aa^Voa, Aa, Ha, Aa^Fma, Aa, Aa^Fma, Ha, Ms, Ms, Ms, Ms, Ms, Ms, Ms^Xm, Ms^Xm
Ms^Xm, Ms^Xm, Ms^Xm, Ms, Aa^Fda, Cfa, Aa, Aa^Fda, Aa^Fma, Aa, Aa, Aa, Aa, Aa, Aa, Aa, Ha, Aa^Fpa, Aa^Fma, Aa^Fpa, Aa^Fda, Ha, Aa, Aa^Fma, Aa, Ha, Aa^Voa, Ha, Aa, Ms, Ms, Ms, Ms, Ms^Xm, Ms^Xm
Ms^Xm, Ms^Xm, Ms^Xm, Ms, Ms, Cfa, Aa, Aa, Aa, Aa^Fpa, Aa, Aa, Aa, Aa^Fda, Aa, Ha, Ha, Ha, Aa^Fma, Aa^Fma, Ms, Ms, Ms, Aa, Aa, Aa^Fma, Ha, Aa, Aa, Aa^Fda, Aa^Fpa, Ms, Ms, Ms^Xm, Ms^Xm
Ms^Xm, Ms^Xm, Ms^Xm, Ms, Ms, Aa^Fda, Ha, Aa^Voa, Aa, Aa^Feta, Aa, Aa^Fma, Ha, Aa^Fpa, Aa, Aa^Feta, Ms, Ms, Ms, Ms, Ms, Ms, Ms, Ms, Ms, Aa, Aa^Fpa, Aa^Fma, Aa, Aa, Aa, Ms, Ms, Ms^Xm, Ms^Xm
Ms^Xm, Ms^Xm, Ms^Xm, Ms^Xm, Ms, Ms, Ms, Aa, Aa, Ha, Aa^Fpa, Ha, Ms, Ms, Ms, Ms, Ms, Ms^Xm, Ms^Xm, Ms, Ms^Xm, Ms^Xm, Ms^Xm, Ms^Xm, Ms^Xm, Ms, Ms, Aa, Aa, Ha, Aa, Aa^Fpa, Ms, Ms^Xm, Ms^Xm
Ms^Xm, Ms^Xm, Ms^Xm, Ms^Xm, Ms^Xm, Ms, Ms, Ms, Ms, Aa^Fpa, Ms, Ms, Ms, Ms, Ms^Xm, Ms, Ms^Xm, Ms^Xm, Ms^Xm, Ms^Xm, Ms, Ms^Xm, Ms, Ms^Xm, Ms, Ms^Xm, Ms, Aa, Aa^Fpa, Aa, Aa^Fma, Aa^Voa, Ms, Ms^Xm, Ms^Xm
Ms^Xm, Ms^Xm, Ms^Xm, Ms^Xm, Ms^Xm, Ms^Xm, Ms^Xm, Ms, Ms^Xm, Ms, Ms^Xm, Ms, Ms^Xm, Ms^Xm, Ms^Xm, Ms^Xm, Ms^Xm, Ms^Xm, Ms, Ms, Ms, Ms, Aa, Ms, Aa^Voa, Ms, Aa, Aa, Ha, Aa, Aa, Ha, Ms, Ms^Xm, Ms^Xm
Ms^Xm, Ms^Xm, Ms^Xm, Ms^Xm, Ms^Xm, Ms^Xm, Ms^Xm, Ms^Xm, Ms^Xm, Ms^Xm, Ms^Xm, Ms^Xm, Ms^Xm, Ms^Xm, Ms, Ms^Xm, Ms, Ms, Ha, Ms, Aa, Aa, Aa^Fda, Aa^Fma, Ha, Aa^Fpa, Aa, Aa, Ha, Ha, Aa^Fpa, Aa^Fma, Ms, Ms^Xm, Ms^Xm
Ms^Xm, Ms^Xm, Ms^Xm, Ms^Xm, Ms^Xm, Ms^Xm, Ms^Xm, Ms^Xm, Ms^Xm, Ms^Xm, Ms, Ms, Ms, Ms, Ms, Ms, Aa, Aa, Aa, Aa^Fpa, Aa^Fpa, Aa, Aa, Aa^Fda, Aa, Aa, Aa, Ha, Cfa, Aa^Fpa, Cfa, Ha, Ms, Ms^Xm, Ms^Xm
Ms^Xm, Ms^Xm, Ms^Xm, Ms^Xm, Ms^Xm, Ms^Xm, Ms^Xm, Ms^Xm, Ms, Ms, Ms, Ms, Ms, Ms, Aa^Fma, Aa^Voa, Aa, Aa, Aa^Fpa, Aa, Aa, Ha, Aa^Fpa, Aa, Aa^Voa, Ha, Ha, Aa, Cfa, 3 Kfa, Cfa, Ms, Ms, Ms^Xm, Ms^Xm
Ms^Xm, Ms^Xm, Ms^Xm, Ms^Xm, Ms^Xm, Ms^Xm, Ms, Ms, Ms, Ms, Coa, Aa^Fpa, Ha, Aa, Ha, Ha, Aa, Aa, Aa^Fpa, Aa^Voa, Aa^Fma, Ha, Ha, Ha, Ha, Aa^Fda, Ha, Aa, Aa^Fda, Ha, Ms, Ms, Ms, Ms^Xm, Ms^Xm
Ms^Xm, Ms^Xm, Ms^Xm, Ms^Xm, Ms, Ms, Coa, Ha, Aa^Voa, Aa^Fpa, Aa^Voa, Ha, Ha, Aa^Fma, Aa^Fpa, Aa^Fma, Aa, Aa^Fpa, Aa, Aa^Fda, Aa^Fpa, Aa^Fpa, Ms, Aa^Fda, Ms, Ha, Aa, Aa, Ms, Ms, Ms, Ms, Ms, Ms^Xm, Ms^Xm
Ms^Xm, Ms^Xm, Ms^Xm, Ms, Ms, Ms, 4 Koa, Coa, Aa, Ha, Aa, Ha, Ha, Aa, Aa, Aa, Aa, Aa, Aa^Fma, Aa, Ms, Ms, Ms^Xm, Ms, Ms^Xm, Ms, Ms, Ms, Ms, Ms, Ms, Ms, Ms^Xm, Ms^Xm, Ms^Xm
Ms^Xm, Ms^Xm, Ms^Xm, Ms, Ms, Coa, Coa, Coa, Aa^Fma, Ha, Coa, Aa, Aa^Fma, Ha, Ha, Aa^Voa, Aa^Fma, Aa, Aa^Fma, Aa, Ms, Ms, Ms, Ms^Xm, Ms, Ms^Xm, Ms^Xm, Ms^Xm, Ms^Xm, Ms^Xm, Ms^Xm, Ms^Xm, Ms^Xm, Ms^Xm, Ms^Xm
Ms^Xm, Ms^Xm, Ms^Xm, Ms, Ms, Ms, Ms, Ha, Ha, Aa^Voa, Ha, Aa, Aa^Fpa, Aa, Aa, Aa^Fpa, Ha, Aa, Aa, Ha, Ha, Ms, Ms, Ms, Ms, Ms, Ms, Ms^Xm, Ms, Ms^Xm, Ms^Xm, Ms^Xm, Ms^Xm, Ms^Xm, Ms^Xm
Ms^Xm, Ms^Xm, Ms^Xm, Ms, Ms, Ms, Ms, Ms, Coa, Ha, Ha, Ha, Aa, Ha, Aa^Fma, Aa, Ha, Aa, Aa, Aa, Aa, Ha, Aa, Aa, Ms, Ms, Ms, Ms, Ms, Ms, Ms, Ms, Ms, Ms, Ms
Ms^Xm, Ms^Xm, Ms^Xm, Ms^Xm, Ms^Xm, Ms, Ms, Ms, Ms, Ha, Ms, Ms, Ms, Aa, Aa, Ha, Aa, Ha, Aa^Fma, Ha, Aa^Fma, 2 Aa^Fda, Aa^Fpa, Aa, Ha, Ms, Aa, Aa, Aa, Aa^Fda, Aa^Fpa, Ms, Aa, Ms, Ms
Ms^Xm, Ms^Xm, Ms^Xm, Ms^Xm, Ms^Xm, Ms^Xm, Ms^Xm, Ms^Xm, Ms^Xm, Ms, Ms^Xm, Ms, Ms, Ms, Ms, Ms, Ms, Aa, Ha, Ha, Ha, Aa, Ha, Aa^Fpa, Aa^Fpa, Aa^Fma, Aa, Aa^Fpa, Aa^Vla, Aa, Aa, Aa, Aa, Aa^Fpa, Aa
Ms^Xm, Ms^Xm, Ms^Xm, Ms^Xm, Ms^Xm, Ms^Xm, Ms^Xm, Ms^Xm, Ms^Xm, Ms^Xm, Ms^Xm, Ms^Xm, Ms^Xm, Ms, Ms, Ms, Ms, Ms, Ha, Aa^Voa, Ha, Aa^Fda, Aa, Aa, Aa^Fpa, Aa^Fma, Ha, Cea^Ebn, Aa, Cea, Cea, Ha, Aa, Aa, Aa^Fma
Ms^Xm, Ms^Xm, Ms^Xm, Ms^Xm, Ms^Xm, Ms^Xm, Ms^Xm, Ms^Xm, Ms^Xm, Ms^Xm, Ms^Xm, Ms^Xm, Ms^Xm, Ms^Xm, Ms^Xm, Ms, Ms, Ms, Ms, Ha, Aa, Aa^Fda, Aa, Aa, Aa, Aa, Aa, Aa^Vca, Cea, 1 Kea, Aa, Aa^Vca, Ha, Aa^Fpa, Aa^Feta
Ms^Xm, Ms^Xm, Ms^Xm, Ms^Xm, Ms^Xm, Ms^Xm, Ms^Xm, Ms^Xm, Ms^Xm, Ms^Xm, Ms^Xm, Ms^Xm, Ms^Xm, Ms^Xm, Ms^Xm, Ms^Xm, Ms^Xm, Ms, Ms, Ms, Ms, Aa, Ha, Aa, Ha, Aa, Aa, Aa, Aa, Cea, Aa^Vla, Cea^Ebn, Aa^Fpa, Aa, Ha
Ms^Xm, Ms^Xm, Ms^Xm, Ms^Xm, Ms^Xm, Ms^Xm, Ms^Xm, Ms^Xm, Ms^Xm, Ms^Xm, Ms^Xm, Ms^Xm, Ms^Xm, Ms^Xm, Ms^Xm, Ms^Xm, Ms^Xm, Ms^Xm, Ms, Ms, Ms, Ha, Aa, Aa, Aa, Aa^Fda, Aa, Aa, Aa, Aa^Fpa, Aa, Aa^Fpa, Ha, Aa, Aa^Fda
