Ms^Xm, Ms^Xm, Ms^Xm, Ms^Xm, Ms^Xm, Ms^Xm, Xu, Ms^Xm, Ms^Xm, Ms, Ms, Ha, Ms, Ms, Ms, Ms, Ms^Xm, Gg, Ms, Ms, Ms, Ms^Xm, Ms^Xm, Xu, Xu, Xu, Xu, Xu, Xu, Xu, Xu, Xu, Xu, Xu, Xoa, Xoa, Uu, Uu, Ur
Ms^Xm, Ms^Xm, Ms^Xm, Ms^Xm, Xu, Xu, Xu, Xu, Xu, Ms^Xm, Ms^Xm, Ms, Ha, Ms, Ms, Ms, Ms^Xm, Ms^Xm, Ms, Ms, Ha, Ms, Ms, Ms^Xm, Ms^Xm, Xu, Xu, Xu, Xu, Xu, Xoa^Efs, Xoa, Xoa, Xoa^Efs, Uh, Uh, Ur, Ur, Uh
Ms^Xm, Ms^Xm, Ms^Xm, Xu, Xu, Xu, Qxu, Xu, Xu, Xu, Xu, Ms^Xm, Ms^Xm, Ha, Ms, Ms, Ms, Ms^Xm, Ha, Ha, Qxu, Ha, Ha, Ha, Qxu, Xoa, Xoa, Xu, Xoa, Xoa, Uh, Uu^Tf, Uu^Vud, Uu, Ur, Ur, Uh, Uu^Vud, Xoa
Ms^Xm, Ms^Xm, Xu, Xu, Xu, Qxu, Qxu, Qxu, Uh^Tf, Xu, Xu, Xu, Ms^Xm, Ms^Xm, Ms, Ms, Ha, Ha, Ha, Qxu, Qxu, Qxu, Qxu, Qxu, Qxu, Qxu, Xos, Xu, Xoa, Uu^Tf, Uh, Cud, 4 Kud, Ur, Ur, Ur, Uu, Xoa, Xu
Ms^Xm, Ms^Xm, Xu, Xu, Qxu, Qxu, Uu^Vu, Uu, Ur, Uh, Xu, Xu, Xu, Ms^Xm, Ms, Ms, Ms, Ms, Ms, Qxu, Qxu, Qxu, Qxu, Qxu, Qxu, Qxu, Qxu, Xos^Efs, Xos, Uu^Vud, Ur, Cud, Ur, Cud, Uu, Uu^Vud, Uu^Tf, Xoa, Xu
Ms^Xm, Ms^Xm, Xu, Xu, Qxu, Qxu, Uu^Tf, Ur, Qxu, Qxu, Xu, Xu, Xu, Ms^Xm, Ms^Xm, Ms, Ms^Xm, Ms, Qxu, Qxu, Qxu, Qxu, Qxu, Qxu, Qxu, Qxu, Qxu, Qxu, Qxu^Bcx/, Ur^Pr\o, Ur^Pr\o, Ur, Uu, Uu^Tf, Xoa, Uh, Xoa, Xoa, Xu
Ms^Xm, Ms^Xm, Xu, Xu, Uh^Tf, Uu, Ur, Uu, Uu, Qxu, Xu, Xu, Xu, Xu, Xu, Ms^Xm, Xu, Xu, Xoa^Efs, Qxu, Qxu, Qxu, Qxu, Qxu, Qxu, Qxu, Qxu^Bcx/, Qxu^Bcx/, Qxu^Bcx/, Qxu^Bcx/, Qxu^Bcx/, Ur^Pr\o, Xos^Efs, Xoa, Xu, Xoa, Xu, Xu, Xu
Ms^Xm, Ms^Xm, Xu, Xu, Uu, Uh, Qxu, Ur, Uu^Tf, Uh, Xu, Xu, Xu, Xu, Xu, Xu, Xu, Xoa, Cud, Uh, Uh, Qxu, Rb, Qxu, Qxu^Bcx/, Qxu^Bcx/, Qxu^Bcx/, Qxu^Bcx/, Qxu^Bcx/, Qxu^Bcx/, Qxu, Qxu, Qxu, Xos, Xoa, Xu, Xu, Xu, Ms^Xm
Ms^Xm, Ms^Xm, Xu, Xu, Xu, Qxu, Qxu, Qxu, Ur, Ur, Xu, Xoa, Xoa^Efs, Xu, Uu^Tf, Xu, Ias^Ebn, Uu, Rb, Uu, Ur, Uh, Ur, Ias, Qxu^Bcx/, Qxu^Bcx/, Qxu^Bcx/, Qxu^Bcx/, Qxu, Qxu, Qxu, Qxu, Qxu, Qxu, Xu, Xu, Ms^Xm, Ms^Xm, Ms^Xm
Ms^Xm, Ms^Xm, Ms^Xm, Xu, Xu, Xu, Xu, Uh, Xoa, Xu, Uu^Vud, Uu, Uh, Rb, Ur, Uh, Ias, Ur, Uu^Tf, Ur, Uh, Ur, Rb, Uh, Uu, Qxu^Bcx/, Qxu, Qxu, Qxu, Qxu, Qxu, Qxu, Qxu, Xu, Xu, Xu, Ms^Xm, Ms^Xm, Ms^Xm
Ms^Xm, Ms^Xm, Ms^Xm, Xu, Xu, Xu, Xu, Xu, Xoa^Efs, Uu, Uu, Uu, Ur, Rb, Ias, Ur, Ur, Ur, Xoa, Uu, Cud, Ias, Uu^Tf, Uu^Ebn, Uu^Tf, Qxu, Qxu, Qxu, Qxu, Qxu, Qxu, Qxu, Xu, Xu, Xu, Ms^Xm, Ms^Xm, Ms^Xm, Ms^Xm
Ms^Xm, Ms^Xm, Ms^Xm, Xu, Xu, Xu, Xu, Xoa, Cud, Uh, Uu^Tf, Uh, Ur, Uu, Xu, Ias, Xu, Xu, Xu, Xoa, Xoa, Xoa, Xu, Uu^Tf, Qxu, Qxu, Qxu, Qxu, Qxu, Qxu, Qxu, Xu, Xu, Xu, Ms^Xm, Ms^Xm, Ms^Xm, Ms^Xm, Ms^Xm
Ms^Xm, Ms^Xm, Ms^Xm, Xu, Xu, Xu, Xu, Xoa, Uu^Tf, Uh, Ur, Ur, Xoa, Xu, Xu, Xu, Xu, Xu, Xu, Xu, Xu, Xu, Qxu, Qxu, Qxu, Qxu, Qxu, Qxu, Qxu, Qxu, Xu, Xu, Xu, Ms^Xm, Ms^Xm, Ms^Xm, Ms^Xm, Ms^Xm, Ms^Xm
Ms^Xm, Ms^Xm, Ms^Xm, Ms^Xm, Ms^Xm, Xu, Xu, Xoa, Ha, Uu, Ur, Cud, Xoa, Xu, Xu, Xu, Xu, Xu, Ms^Xm, Xu, Ms^Xm, Wog, Wog, Qxu, Xu, Xu, Xu, Qxu, Xu, Xu, Xu, Xu, Ms^Xm, Ms^Xm, Ms^Xm, Ms^Xm, Ms^Xm, Ms^Xm, Ms^Xm
Ms^Xm, Ms^Xm, Ms^Xm, Ms^Xm, Ms^Xm, Ms^Xm, Ms^Xm, Ms^Xm, Aa, Ha, Rra, Xoa, Xu, Xu, Ms^Xm, Xu, Ms^Xm, Ms^Xm, Ms^Xm, Ms^Xm, Wog, Wog, Ai, Ms^Xm, Ms^Xm, Xu, Xu, Xu, Xu, Xu, Xu, Xu, Ms^Xm, Ms^Xm, Ms^Xm, Ms^Xm, Ms^Xm, Ms^Xm, Ms^Xm
Ms^Xm, Ms^Xm, Ms^Xm, Ms^Xm, Ms^Xm, Ms^Xm, Ms^Xm, Ms^Xm, Aa^Fda, Rra, Ha, Ms^Xm, Ms^Xm, Ms^Xm, Ms^Xm, Ms^Xm, Ms^Xm, Ms^Xm, Ai, Ai, Ai, Wog, Aa^Vla, Ms^Xm, Ms^Xm, Ms^Xm, Ms^Xm, Ms^Xm, Ms^Xm, Ms^Xm, Ms^Xm, Xu, Xu, Ms^Xm, Ms^Xm, Ms^Xm, Ms^Xm, Ms^Xm, Ms^Xm
Ms^Xm, Ms^Xm, Ms^Xm, Ms^Xm, Ms^Xm, Ms^Xm, Aa^Fpa, Ha, Rra, Aa^Fma, Aa, Ms^Xm, Ms^Xm, Ms^Xm, Wog, Wog, Ai, Wog, Wog, Wog, Aa^Fpa, Aa, Ha, Aa^Fpa, Aa, Ms, Ms, Ms, Ms^Xm, Ms^Xm, Ms^Xm, Xu, Xu, Ms^Xm, Ms^Xm, Ms^Xm, Ms^Xm, Ms^Xm, Ms^Xm
Ms^Xm, Ms^Xm, Ms^Xm, Ms^Xm, Ms, Ms^Xm, Aa, Aa, Aa, Rra, Rra, Aa, Wog, Ai, Wog, Ai, Ai, Ai, Ha, Aa^Fda, Aa, Rra, Rra, Rra, Aa, Rra, Ha, Aa, Aa^Fpa, Ms^Xm, Xoa^Efs, Xu, Xu, Ms^Xm, Ms^Xm, Ms^Xm, Ms^Xm, Ms^Xm, Ms^Xm
Ms^Xm, Ms^Xm, Ms^Xm, Ms, Ms, Ms, Aa^Fma, Aa^Fpa, Aa, Ha, Rra, Rra, Wog^Bsa\, Wog, Ha, Aa^Fda, Aa, Rra, Rra, Rra, Aa, Ha, Aa^Fma, Aa^Fda, Aa, Rra, Aa^Fda, Rra, Aa^Fpa, Uh, Cud, Xoa, Xoa, Xu, Ms^Xm, Ms^Xm, Ms^Xm, Ms^Xm, Ms^Xm
Ms^Xm, Ms^Xm, Ms^Xm, Ms^Xm, Ms^Xm, Aa, Aa, Aa, Aa, Aa, Aa, Ai^Bsa\, Ai^Bsa\, Wog^Bsa\, Rra, Rra, Ms^Xm, Ha, Ms^Xm, Ms^Xm, Ms^Xm, Aa, Ms, Aa, Ha, Aa, Ms, Rra, Ur, Uh, Uu, Uh, Xu, Xu, Ms^Xm, Ms^Xm, Ms^Xm, Ms^Xm, Ms^Xm
Ms^Xm, Ms^Xm, Ms^Xm, Ms^Xm, Ms^Xm, Ms^Xm, Aa^Vea, Aa^Feta, Aa^Fma, Aa, Ha, Wog, Ai, Rra, Ms, Ms, Ms^Xm, Ms^Xm, Xu, Ms^Xm, Ms^Xm, Ms^Xm, Ms^Xm, Ms, Ms^Xm, Ms^Xm, Ms^Xm, Xoa, Cud, Ur, Rb, Uh, Xu, Xu, Ms^Xm, Ms^Xm, Ms^Xm, Ms^Xm, Ms^Xm
Ms^Xm, Ms^Xm, Ms^Xm, Ms^Xm, Ms, Ms, Ms, Aa, Ms^Xm, Ms^Xm, Ms^Xm, Wog, Wog, Wwg, Ms^Xm, Ms^Xm, Xu, Xu, Xoa, Xu, Xu, Ms^Xm, Xu, Ms^Xm, Xoa^Efs, Xoa, Xoa, Xoa^Efs, Uu, Ur, Uu^Tf, Uu^Tf, Xu, Xu, Ms^Xm, Ms^Xm, Ms^Xm, Ms^Xm, Ms^Xm
Ms^Xm, Ms^Xm, Ms^Xm, Ms^Xm, Ms^Xm, Ms, Ms^Xm, Ms^Xm, Ms^Xm, Ms^Xm, Ms^Xm, Ms, Wog, Wog, Wwg, Xoa, Xoa, Xoa^Efs, 8 Kud, Xoa^Efs, Xoa, Xu, Xoa, Xoa, Cud, Xoa, Uu^Tf, Uu, Ur, Uu, Uu, Uu^Vud, Xu, Xu, Ms^Xm, Ms^Xm, Ms^Xm, Ms^Xm, Ms^Xm
Ms^Xm, Ms^Xm, Ms^Xm, Ms^Xm, Ms^Xm, Ms^Xm, Ms^Xm, Ms^Xm, Ms, Ms, Ha, Ai, Wog, Ai, Ias, Uu, Uu, Cud, Uu^Vud, Cud, Uu^Vud, Xoa, Uu, Uu^Tf, Uu, Cud, Uh, Ur, Rb, Rb, Rb, Xu, Xu, Xu, Ms^Xm, Ms^Xm, Ms^Xm, Ms^Xm, Ms^Xm
Ms^Xm, Ms^Xm, Ms^Xm, Ms^Xm, Ms^Xm, Ms^Xm, Wog, Wog, Wog, Ha, Ai, Wog, Wwg, Wwg, Ias, Uh, Ur, Uu, Ur, Uu^Tf, Ur, Uu^Tf, Ur, Ur, Ur, Uu, Ur, Ur, Rb, Uh, Rb, Xu, Xu, Ms^Xm, Ms^Xm, Ms^Xm, Ms^Xm, Ms^Xm, Ms^Xm
Ms^Xm, Ms^Xm, Ms^Xm, Ms^Xm, Ai, Wog, Ai, Ai, Ai, Wog, Wwg, Ai, Rb^Ebn, Rb, Uu, Uu, Ur, Uh, Rb, Ur, Ias, Rb, Ias, Uu, Xu, Uu, Rb^Ebn, Uu^Tf, Xu, Uu, Xu, Xu, Xu, Ms^Xm, Ms^Xm, Ms^Xm, Ms^Xm, Ms^Xm, Ms^Xm
Ms^Xm, Ms^Xm, Ai, Ai, Ai, Ai, Xu, Xu, Xu, Wwg, Uu^Vud, Ias, Ur, Ur, Ur, Uu, Xoa, Cud, Cud, Ias, Xoa, Uh, Xu, Xu, Xu, Xu, Xu, Xu, Xu, Xu, Xu, Xu, Ms^Xm, Ms^Xm, Ms^Xm, Ms^Xm, Ms^Xm, Ms^Xm, Ms^Xm
Ms^Xm, Ms^Xm, Ai, Ai, Ms^Xm, Ms^Xm, Xu, Xu, Ias, Rb, Uu, Ur, Uh, Uh, Xoa, Xoa, Xu, Xoa, Xoa, Xoa, Xu, Xu, Xu, Xu, Ms^Xm, Xu, Ms^Xm, Xu, Ms^Xm, Xu, Ms^Xm, Ms^Xm, Ms^Xm, Ms^Xm, Ms^Xm, Ms^Xm, Ms^Xm, Ms^Xm, Ms^Xm
Ms^Xm, Ms^Xm, Ai, Ai, Ms^Xm, Ms^Xm, Xu, Xu, Uh, Ias, Cud, Ur, Ur, Cud, Xoa^Efs, Xu, Ms^Xm, Xu, Xu, Xu, Ms^Xm, Xu, Ms^Xm, Ms^Xm, Ms^Xm, Ms^Xm, Ms^Xm, Ms^Xm, Ms^Xm, Ms^Xm, Ms^Xm, Ms^Xm, Ms^Xm, Ms^Xm, Ms^Xm, Ms^Xm, Ms^Xm, Ms^Xm, Ms^Xm
Ai, Ai, Ai, Ai, Ms^Xm, Ms^Xm, Xu, Xu, Xu, Uh, Aa, Uu^Tf, Rra, Aa, Ha, Ms^Xm, Ms^Xm, Ms^Xm, Ms^Xm, Ms^Xm, Ms^Xm, Ms^Xm, Ms, Ms, Ms, Ms^Xm, Ms^Xm, Ms^Xm, Ms, Ms^Xm, Ms, Ms, Ms, Ms^Xm, Ms^Xm, Ms^Xm, Ms^Xm, Ms^Xm, Ms^Xm
Ai, Ai, Ms^Xm, Ha, Ms^Xm, Ms^Xm, Ms^Xm, Xu, Xu, Xu, Ha, Aa, Aa^Fda, Rra, Aa^Fpa, Ms, Ms, Ms, Ms, Ms, Ms, Ms, Aa, Ha, Aa, Ha, Ha, Ha, Cfa, Ms, Aa^Vla, Aa^Fpa, Aa^Fma, Ms^Vhha, Ms, Ms^Xm, Ms^Xm, Ms^Xm, Ms^Xm
Ms^Xm, Ms^Xm, Ms^Xm, Ha, Ha, Ms^Xm, Ms^Xm, Ms^Xm, Ms^Xm, Ms^Xm, Ms, Ha, Aa, Rra, Aa, Aa^Fda, Aa, Ha, Aa, Aa^Fpa, Ha, Aa, Aa^Fda, Aa, Ha, Aa^Fpa, Aa, Aa, Aa^Fda, Ha, Aa^Fda, Ha, Cfa, 7 Kfa, Ms, Ms^Xm, Ms^Xm, Ms^Xm, Ms^Xm
Ms^Xm, Ms^Xm, Ms^Xm, Ms^Xm, Ms, Ms, Ms^Xm, Ms^Xm, Ms^Xm, Ms^Xm, Ms, Ha, Aa, Rra, Rra, Aa^Fma, Rra, Aa, Ha, Aa, Rra, Rra, Aa, Rra, Rra, Aa^Fda, Rra, Rra, Rra, Aa^Fma, Aa, Aa^Fma, Ha^Ebn, Cfa, Aa, Ms, Ms, Ms^Xm, Ms^Xm
Ms^Xm, Ms^Xm, Ms, Ms, Aa, Ms, Ms, Ms^Xm, Ms^Xm, Ms, Aa^Fpa, Aa^Vla, Aa, Aa, Aa, Aa^Fda, Ha, Rra, Ha, Rra, Aa^Fda, Ha, Ha, Aa^Fda, Ms, Rra, Ms, Aa^Fpa, Aa^Fma, Ha, Rra, Ha, Aa, Aa, Cfa, Ms, Ms, Ms^Xm, Ms^Xm
Ms^Xm, Ms^Xm, Ms, Aa^Fma, Aa^Fma, Aa^Fma, Ms, Ms^Xm, Ms^Xm, Ms, Ms, Aa^Fda, Ms, Ha, Ha, Aa, Aa^Fma, Ha, Ms, Aa, Ms, Ms, Ms, Ms, Ms^Xm, Ms, Ms^Xm, Ms, Cfa, Ha^Ebn, Aa, Rra, Ha, Aa, Ms, Ms, Ms^Xm, Ms^Xm, Ms^Xm
Ms^Xm, Ms^Xm, Ms, Aa^Vaa, Aa, Ai, Ai, Ms, Ms^Xm, Ms^Xm, Ms^Xm, Ms, Ms, Ms, Ms, Ms, Ms^Xm, Ms, Ms^Xm, Ms, Ms^Xm, Ms, Ms^Xm, Ms^Xm, Ms^Xm, Ms^Xm, Ms, Ms, Ha, Aa, Rra, Rra, Ha, Aa^Vla, Ms, Ms, Ms^Xm, Ms^Xm, Ms^Xm
Ms^Xm, Ms^Xm, Ms^Xm, Aa^Fma, Ai, Aa^Feta, Ai, Ms, Ms^Xm, Ms^Xm, Ms^Xm, Ms^Xm, Ms^Xm, Ms^Xm, Ms^Xm, Ms^Xm, Ms^Xm, Ms^Xm, Ms^Xm, Ms^Xm, Ms^Xm, Ms^Xm, Ms^Xm, Ms^Xm, Ms, Ms, Aa^Fma, Ha, Rra, Rra, Aa, Aa^Fpa, Ms, Ms, Ms, Ms, Ms^Xm, Ms^Xm, Ms^Xm
Ms^Xm, Ms^Xm, Ms^Xm, Ms^Xm, Ms, Ai, Ms, Ms, Ms^Xm, Ms^Xm, Ms^Xm, Ms^Xm, Ms^Xm, Ms^Xm, Ms^Xm, Ms^Xm, Ms^Xm, Ms^Xm, Ms, Ms^Xm, Ms, Ms, Ha, Ms, Ms, Ms, Aa, Aa, Rra, Aa^Fma, Ha, Cfa, Ms, Ms, Ms^Xm, Ms^Xm, Ms^Xm, Ms^Xm, Ms^Xm
Ms^Xm, Ms^Xm, Ms^Xm, Ms^Xm, Ms^Xm, Ms^Xm, Ms^Xm, Ms^Xm, Ms^Xm, Ms^Xm, Ms^Xm, Ms^Xm, Ms^Xm, Ms^Xm, Ms, Ms^Xm, Ms, Ms, Ms, Ms, Aa, Aa, Aa, Aa^Fma, Ha, Rra, Aa^Fma, Rra, Aa, Aa^Fpa, Ms, Ms, Ms, Ms^Xm, Ms^Xm, Ms^Xm, Ms^Xm, Ms^Xm, Ms^Xm
Ms^Xm, Ms^Xm, Ms^Xm, Ms^Xm, Ms^Xm, Ms^Xm, Ms^Xm, Ms^Xm, Ms^Xm, Ms^Xm, Ms, Ms^Xm, Ms, Ms, Ms, Ms, Ha, Aa, Aa, Aa, Ha, Aa^Fda, Rra, Aa^Fma, Rra, Rra, Aa, Aa^Fda, Ms, Ms, Ms, Ms, Ms^Xm, Ms^Xm, Ms^Xm, Ms^Xm, Ms^Xm, Ms^Xm, Ms^Xm
Ms^Xm, Ms^Xm, Ms^Xm, Ms^Xm, Ms^Xm, Ms^Xm, Ms, Ms, Ms, Ms, Ms, Ms, Aa, Aa, Ha, Aa^Fma, Ha, Aa^Fda, Aa^Fda, Aa, Rra, Rra, Aa^Fda, Rra, Ms, Aa^Vla, Ha, Aa^Fda, Ms, Ms, Ms^Xm, Ms^Xm, Ms^Xm, Ms^Xm, Ms^Xm, Ms^Xm, Ms^Xm, Ms^Xm, Ms^Xm
Ms^Xm, Ms^Xm, Ms^Xm, Ms^Xm, Ms^Xm, Ms^Xm, Ms, Ms, Ms, Ms, Aa, Ha, Rra, Rra, Rra, Aa^Feta, Rra, Aa, Rra, Rra, Aa, Aa^Fma, Ms, Ms, Ms, Ms, Ms, Ms, Ms, Ms^Xm, Ms^Xm, Ms^Xm, Ms^Xm, Ms^Xm, Ms^Xm, Ms^Xm, Ms^Xm, Ms^Xm, Ms^Xm
Ms^Xm, Ms^Xm, Ms^Xm, Ms^Xm, Ms^Xm, Ms, Aa, Aa^Fda, Ha, Ha, Aa^Fda, Rra, Ha, Aa, Aa, Rra, Ha, Ha, Ms, Aa, Ms, Ms, Ms, Ms, Ms^Xm, Ms^Xm, Ms^Xm, Ms^Xm, Ms^Xm, Ms^Xm, Ms^Xm, Ms^Xm, Ms^Xm, Ms^Xm, Ms^Xm, Ms^Xm, Ms^Xm, Ms^Xm, Ms^Xm
Ms^Xm, Ms^Xm, Ms^Xm, Ms^Xm, Ms, Ms, Aa^Vla, Ha, Aa^Feta, Aa, Rra, Aa, Ha, Aa^Vla, Ms, Ms, Ms^Xm, Ms, Ms^Xm, Ms, Ms^Xm, Ms^Xm, Ms^Xm, Ms^Xm, Ms^Xm, Ms^Xm, Xu, Xu, Xu, Xu, Xu, Ms^Xm, Ms^Xm, Ms^Xm, Ms^Xm, Ms^Xm, Ms^Xm, Ms^Xm, Ms^Xm
Ms^Xm, Ms^Xm, Ms^Xm, Ms^Xm, Ms, Ms, Aa^Fma, Aa^Fpa, Rra, Rra, Aa^Fma, Ms, Ms, Ms, Ms^Xm, Ms^Xm, Ms^Xm, Ms^Xm, Ms^Xm, Ms^Xm, Ms^Xm, Ms^Xm, Xu, Xu, Xu, Xu, Xu, Xu, Xu, Xu, Xoa^Efs, Xu, Xu, Ms^Xm, Xu, Ms^Xm, Ms^Xm, Ms^Xm, Ms^Xm
Ms^Xm, Ms^Xm, Ms^Xm, Ms^Xm, Ms, Aa, Aa, Aa, Rra, Aa, Aa, Ms^Xm, Ms^Xm, Ms^Xm, Ms^Xm, Ms^Xm, Xu, Xu, Xu, Xu, Xu, Xu, Xu, Xu, Xu, Xu, Xu, Xu, Uu^Vud, Xoa, Cud, Xoa, Xoa^Efs, Xu, Xu, Xu, Xu, Xu, Xu
Ms^Xm, Ms^Xm, Ms^Xm, Ms, Ms, Aa, Aa, Aa, Ha, Aa, Ha, Ms^Xm, Xu, Ms^Xm, Xu, Xu, Xu, Xu, Xu, Xu, Xu, Xu, Xu, Xu, Xu, Xu, Uh, Rb, Rb, Rb, Cud, 6 Kud, Cud, Xoa, Xu, Xu, Xu, Xu, Xu
Ms^Xm, Ms^Xm, Ms^Xm, Ms, Ms, Ha, Aa, Rra, Rra, Ha, Ias, Xoa^Efs, Xoa^Efs, Xu, Xu, Xu, Uh, Xoa^Efs, Xoa, Xoa, Xoa^Efs, Xoa, Xu, Xu, Xoa^Efs, Xoa^Efs, Uu, Uu^Vud, Ur, Rb, Uu, Cud, Rb, Xoa, Xoa, Xu, Xu, Xu, Xu
Ms^Xm, Ms^Xm, Ms^Xm, Ms^Xm, Ms^Xm, Aa^Fda, Uh, Cud, Ur, Uh, Cud, Uu, Uh, Xoa, Uh, Ias^Ebn, Uu^Tf, Uu, Rb, Cud, Uu, Uh, Rb, Xoa, Uu, Uu, Ur, Ur, Cud, Ur, Ur, Uu, Uu^Vud, Ias, Uh, Xu, Xu, Xu, Xu
Ms^Xm, Ms^Xm, Ms^Xm, Ms^Xm, Xu, Xoa, Uu^Vud, Uu, Ur, Uh, Uu^Tf, Rb, Uu, Uu, Ur, Ur, Ur, Ur, Ur, Uu, Uu, Rb, Uh, Uh, Ur, Uu^Tf, Uu, Uu, Cud^Ebn, Cud, Rb, Rb, Uu, Ias^Ebn, Ias, Xu, Xu, Xu, Xu
Ms^Xm, Ms^Xm, Ms^Xm, Ms^Xm, Xu, Xoa, Xoa, Uu^Ebn, Uu, Ur, Ur, Ur, Ur, Uu, Uh, Uh, Cud, Uh, Uh, Uu, Ur, Ur, Ur, Ur, Uu^Tf, Rb, Xoa^Efs, Cud, Xoa^Efs, Uh, Rb, Ur, Ur, Uu, Uu^Vud, Rb, Xu, Xu, Xu
Ms^Xm, Ms^Xm, Ms^Xm, Xu, Xu, Xu, Xu, Uu^Tf, Qxu, Cud, Qxu, Qxu, Qxu, Cud, Rb, Ias, Qxu, Qxu, Qxu, Uu, Cud, Uh, Qxu, Cud, Qxu, Qxu, Qxu, Xoa, Qxu, Uu, Cud, Rb, Ur, Ias, Ias, Uu^Tf, Xu, Xu, Xu
Ms^Xm, Ms^Xm, Ms^Xm, Xu, Xu, Xu, Qxu, Qxu, Qxu, Qxu, Qxu, Qxu, Qxu, Qxu, Qxu, Qxu, Qxu, Qxu, Qxu, Qxu, Qxu, Qxu, Qxu, Qxu, Qxu, Qxu, Qxu, Qxu, Qxu, Qxu, Qxu, Uu, Ur, Uu^Tf, Uh, Uu, Uu, Xu, Xu
Ms^Xm, Ms^Xm, Xu, Xu, Xu, Qxu, Qxu, Qxu, Qxu, Qxu, Qxu, Qxu, Qxu, Qxu, Qxu, Qxu, Qxu, Qxu, Qxu, Qxu, Qxu, Qxu, Qxu, Qxu, Qxu, Qxu, Qxu, Qxu, Qxu, Qxu, Qxu, Rb, Ias, Ur, Uu, Rb, Uu, Xu, Xu
Ms^Xm, Ms^Xm, Xu, Xu, Xu, Qxu, Qxu, Qxu, Qxu, Qxu, Qxu, Qxu, Qxu, Qxu, Qxu, Qxu, Qxu, Qxu, Qxu, Qxu, Qxu, Qxu, Qxu, Qxu, Qxu, Qxu, Qxu, Qxu, Qxu, Qxu, Xoa, Xoa^Efs, Uu, Ur, Rb, Uu, Uu, Xu, Xu
Ms^Xm, Ms^Xm, Ms^Xm, Xu, Xu, Xu, Xu, Xu, Xu, Qxu, Qxu, Qxu, Qxu, Qxu, Qxu, Qxu, Qxu, Qxu, Qxu, Qxu, Qxu, Qxu, Qxu, Qxu, Qxu, Qxu, Qxu, Qxu, Qxu, Qxu, Xoa, Cud, Ias, Uu, Uh, Rb, Xu, Xu, Xu
Ms^Xm, Ms^Xm, Ms^Xm, Xu, Xu, Xu, Xu, Xu, Xu, Qxu, Qxu, Qxu, Qxu, Qxu, Qxu, Qxu, Qxu, Qxu, Qxu, Qxu, Qxu, Qxu, Qxu, Qxu, Xoa^Efs, Qxu, Uu^Ebn, Rb, Ias, Uu^Vud, Uu, Rb, Ur, Ur, Ias, Uu, Xu, Xu, Xu
Ms^Xm, Ms^Xm, Ms^Xm, Ms^Xm, Ms^Xm, Ms^Xm, Ms^Xm, Ms^Xm, Ms^Xm, Xu, Xu, Qxu, Qxu, Qxu, Uh, Uu^Tf, Rb, Qxu, Xoa^Efs, Xoa, Xoa, Qxu, Cud, Xoa, Uh, Rb, Uu, Uh, Ur, Ur, Uu, Ur, Rb, Uu, Rb^Ebn, Uu, Xu, Xu, Xu
Ms^Xm, Ms^Xm, Ms^Xm, Ms^Xm, Ms^Xm, Ms^Xm, Ms^Xm, Ms^Xm, Ms^Xm, Xu, Xu, Xu, Ur^Ebn, Ur, Xu, Uh, Uu^Tf, Uu, Rb, Cud, Uu, Rb, Uu, Uu, Ur, Uu^Tf, Ias, Uu, Ur, Rb, Uh, Uh, Uu, Uh, Xu, Xu, Xu, Xu, Xu
Ms^Xm, Ms^Xm, Ms^Xm, Ms^Xm, Ms^Xm, Ms^Xm, Ms^Xm, Ms^Xm, Ms^Xm, Ms^Xm, Xu, Xu, Uu, Xu, Xu, Xu, Cud, Rb, Rb, Rb, Ur, Ur, Uh, Ur, Rb, Ur, Xu, Ur, Xu, Xu, Xu, Uu, Xu, Xu, Xu, Xu, Xu, Xu, Ms^Xm
Ms^Xm, Ms^Xm, Ms^Xm, Ms^Xm, Ms^Xm, Ms^Xm, Ms^Xm, Ms^Xm, Ms^Xm, Ms^Xm, Xu, Xu, Xu, Xu, Xu, Xu, Xu, Uu^Tf, Uu, Ur, Uu, Uh, Uu, Uu, Xu, Xu, Xu, Xu, Xu, Xu, Xu, Xu, Xu, Xu, Ms^Xm, Xu, Ms^Xm, Ms^Xm, Ms^Xm
Ms^Xm, Ms^Xm, Ms^Xm, Ms^Xm, Ms^Xm, Ms^Xm, Ms^Xm, Ms^Xm, Ms^Xm, Ms^Xm, Ms^Xm, Xu, Xu, Xu, Ms^Xm, Xu, Xu, Xu, Aa, Ur, Rrc, Aa, Aa, Aa^Fda, Ms^Xm, Xu, Ms^Xm, Xu, Ms^Xm, Ms^Xm, Ms^Xm, Xu, Ms^Xm, Ms^Xm, Ms, Ms^Xm, Ms^Xm, Ms^Xm, Ms^Xm
Ms^Xm, Ms^Xm, Ms^Xm, Ms^Xm, Ms^Xm, Ms^Xm, Ms, Ms^Xm, Ms, Ms^Xm, Ms, Ms^Xm, Ms^Xm, Ms^Xm, Ms^Xm, Ms^Xm, Ms^Xm, Ms^Xm, Aa, Aa^Fma, Aa^Fma, Rrc, Aa, Aa, Ms, Ms^Xm, Ms, Ms^Xm, Ms, Ms, Ms, Ms^Xm, Ms, Ms, Ms, Ms, Ms^Xm, Ms^Xm, Ms
Ms^Xm, Ms^Xm, Ms^Xm, Ms^Xm, Ms, Ms, Ms, Ms, Ha^Vhha, Ms, Ms, Ms^Xm, Ms, Ms, Ms, Ms^Xm, Aa^Fda, Ha, Aa^Fma, Ha, Aa, 3 Rrc, Aa, Aa, Aa^Fpa, Ms, Aa^Vla, Ms, Ha, Ms, Ms, Ms, Ms, Ms, Ms, Ms^Xm, Ms^Xm, Ms^Xm, Ms^Xm
Ms^Xm, Ms^Xm, Ms, Ms, Ms, Ms, 5 Kfa, Cfa, Cfa, Ha, Ha, Ms, Aa, Aa, Aa, Ha, Aa, Aa^Fda, Ha, Aa, Aa, Rrc, Rrc, Aa, Aa, Ha, Aa, Aa, Aa, Ha, Ha, Ha, Aa^Fda, Ms, Ms, Ms^Xm, Ms^Xm, Ms^Xm, Ms^Xm
Ms^Xm, Ms^Xm, Ms, Ms, Aa^Fma, Cfa^Ebn, Aa, Aa^Fma, Cfa^Ebn, Ha, Aa^Fma, Aa, Aa^Vla, Aa, Aa, Aa, Aa, Ha, Aa^Fda, Aa, Aa^Fda, Aa, Aa^Fma, Aa^Fpa, Aa, Aa, Aa, Ha, Ha, Aa^Fpa, Aa, Aa^Fma, Aa, Ha, Ms, Ms, Ms, Ms^Xm, Ms
Ms^Xm, Ms, Ms, Ms, Ha^Vhha, Cfa, Cfa, Aa, Ha, Aa, Ha, Aa, Aa, Aa^Fma, Aa, Aa, Aa^Fda, Aa, Aa, Aa, Ha, Rrc, Rrc, Aa, Ha, Ha, Aa^Fma, Aa^Fda, Aa, Aa, Aa, Aa^Fma, Aa, Aa^Fma, Aa^Fda, Ms, Ms, Ms^Xm, Ms^Xm
Ms^Xm, Ms, Ms, Ms, Ms, Aa^Fma, Aa, Aa, Aa, Aa^Fma, Aa^Fda, Aa^Fda, Aa, Aa, Ha, Aa^Fpa, Ha, Aa^Fda, Aa^Vla, Aa^Fda, Aa^Fda, Aa^Fda, Rrc, Aa, Ha, Aa, Aa, Aa, Aa, Aa^Fma, Ha, Ha, Aa^Fda, Aa, Ha, Ms, Ms, Ms^Xm, Ms^Xm
Ms^Xm, Ms, Ms, Ms, Ms, Aa, Aa^Vla, Aa, Aa^Fma, Ha, Aa, Aa^Feta, Aa, Ha, Aa, Aa^Fda, Aa, Aa, Aa, Aa^Fma, Rrc, Rrc, Aa, Aa^Fda, Aa^Feta, Aa, Aa, Aa, Ha, Aa, Aa^Fda, Aa, Aa, Aa^Fma, Cea, Ha, Ha, Ms, Ms
Ms^Xm, Ms^Xm, Ms, Ms, Ms, Aa^Fda, Ha, Aa, Ha, Aa, Ms, Ha, Aa, Aa, Aa, Aa, Ha, Aa, Aa, Aa, Rrc, Aa^Fpa, Aa, Aa^Fda, Aa, Aa, Ha, Aa^Fma, Re^Vct, Cea, Cea, Aa, Re^Ecf, Cea, 1 Kea, Cea, Aa^Fma, Ms, Ms
Ms^Xm, Ms^Xm, Ms, Ms, Ms, Ms, Ms, Aa^Fda, Ms, Ms, Ms, Ms, Ms, Aa^Fma, Aa^Vla, Aa, Aa^Fma, Aa, Aa, Ha, Aa, Aa, Aa, Aa, Aa^Fma, Aa, Aa^Fda, Re^Ecf, Cea, 2 Kea, Re^Vct, Aa^Fma, Aa, Re^Vct, Cea, Re, Aa^Fma, Aa^Fma, Ha
Ms, Ms, Ms, Ms, Ms^Xm, Ms, Ms^Xm, Ms, Ms^Xm, Ms, Ms, Ms, Ms, Ms, Ms, Ha, Aa, Aa^Fda, Ha, Aa, Ha, Rrc, Aa^Fma, Aa, Aa, Aa, Aa, Aa, Aa^Fda, Cea, Aa^Fma, Aa^Feta, Aa, Aa, Aa^Fda, Re^Vct, Aa^Fma, Ha, Aa
Ms, Ms, Ms^Xm, Ms^Xm, Ms^Xm, Ms^Xm, Ms^Xm, Ms^Xm, Ms^Xm, Ms^Xm, Ms^Xm, Ms^Xm, Ms^Xm, Ms, Ms, Aa, Aa^Fma, Aa^Fma, Ha, Aa^Fma, Aa, Rrc, Aa^Fda, Aa, Ha, Ha, Aa, Aa, Ha, Aa, Aa^Feta, Aa, Aa, Aa, Aa^Fpa, Aa^Fda, Ha, Aa^Fma, Aa^Feta
