Xv, Xv, Xv, Xv, Xv, Xv, Xv, Xv, Xv, Xv, Xv, Xv, Xv, Xv, Xv, Xv, Xv, Xv, Xv, Xv, Xv, Xv, Xv, Xv, Xv, Xv, Xv, Xv, Xv, Xv, Xv, Xv, Xv, Xv, Xv, Xv, Xv
Xv, Xv, Xv, Xv, Xv, Xv, Xv, Xv, Xv, Xv, Xv, Xv, Xv, Xv, Xoa, Xv, Xv, Xv, Xv, Xv, Xv, Xv, Xoa, Xoa, Xoa, Xv, Xv, Xv, Xoa, Xv, Xv, Xv, Xv, Xv, Xv, Xv, Xv
Xv, Xv, Xv, Xv, Xv, Xv, Xv, Xv, Xoa, Xv, Xv, Xv, Xoa, Xoa, Uu, Xoa, Xoa, Xv, Xoa, Xoa, Xoa, Xoa, Ias, Ias, Ias, Xoa, Xoa, Xoa, Uu, Xoa, Xoa, Xv, Xv, Xv, Xv, Xv, Xv
Xv, Xv, Xv, Xv, Xoa, Xoa, Xoa, Xoa, Ias, Xoa, Xoa, Xoa, Ias, Ias, Ias, Uu, Uu, Xoa, Ias, Ias, Ias^Pr/, Xoa, Xoa, Ias, Ias^Pr/, Xoa, Ias^Pr\, Uu, Uu, Uu, Xoa, Xoa, Xoa, Xv, Xv, Xv, Xv
Xv, Xv, Xoa, Xoa, Ias, Ias, Ias, Ias^Pr\, Ias^Pr\, Ias, Xoa, Ias, Ur, Ur, Ur, Ias, Uu, Xoa, Xoa, Ias^Pr/, Ias, Ias, Xoa, Ias^Pr/, Ias, Ias, Ias, Ias^Pr\, Xoa, Xoa, Uu, Uu, Uu, Xoa, Xv, Xv, Xv
Xv, Xv, Xoa, Ias, Ias, Cud, Ias, Ias, Xoa, Xoa, Ias, Ias, Ur, Ur, Ur, Ias, Xoa, Xoa, Ias^Pr\, Ias, Ias, Cud, Ias, Ias, Urb, Urb, Urb, Ias, Ias, Ias^Pr\, Ias^Pr\, Uu, Xoa, Xoa, Xoa, Xv, Xv
Xv, Xoa, Xoa, Xoa, Xoa, Ias, Ias^Pr/, Ias^Pr/, Ias, Ias, Ias, Ias, Ias, Ur, Ias, Ias, Xoa, Ias, Ias, Ias^Pr\, Xoa, Ias, Ias, Urb^Vud, Urb, Cud, Urb, Urb^Vud, Urb, Ias, Ias, Xoa, Ias, Ias, Xoa, Xv, Xv
Xv, Xoa, Ias, Ias, Xoa, Xoa, Ias, Ias, Ias, Ias, Cud, Xoa, Xoa, Ias, Xoa, Xoa, Ias, Xoa, Xoa, Xoa, Ias, Ias^Pr\, Ias^Pr\, Ias, Ias, Urb, Urb, Urb, Cud, Urb, Ias, Xoa, Ias, Ias, Ias, Xoa, Xv
Xv, Xoa, Ias^Pr/, Ias^Pr/, Ias, Ias, Ias, Ias, Xoa, Cud, Cud^Vud, Cud, Ias, Xoa, Ias, Ias, Ur, Ias, Ias, Xoa, Xoa, Ias, Xoa, Xoa, Ias^Pr\, Ias, Ias, Urb, Ias, Ias, Xoa, Xoa, Ias^Pr\, Ias, Ias, Xoa, Xv
Xv, Xoa, Ias, Ias, Ias, Cud, Ias, Xoa, Ias, Cud, Cud, Cud, Ias, Xoa, Ias, Ur, 1 Ur, Ur, Ias, Xoa, Ias, Xoa, Xoa, Ias, Ias, Ias^Pr\, Xoa, Ias, Ias, Xoa, Ias, Ias, Ias, Ias^Pr\, Xoa, Xoa, Xv
Xv, Xoa, Ias, Ias, Xoa, Ias, Xoa, Xoa, Ias^Pr\, Ias, Ias, Ias, Ias, Xoa, Ias, Ur, Ur, Ur, Ias, Ias, Cud, Ias, Ias, Xoa, Xoa, Xoa, Ias, Ias, Ias, Xoa, Ias, Cud, Cud, Ias, Ias, Xoa, Xv
Xv, Xoa, Ias, Ias, Xoa, Xoa, Ias, Ias, Ias, Ias^Pr\, Xoa, Ias, Ias, Xoa, Xoa, Ias, Ias, Ias, Xoa, Ias, Ias, Ias, Ias, Ias, Ias, Ias, Ias, Ias, Xoa, Xoa, Ias, Cud, Cud, Cud, Ias, Xoa, Xv
Xv, Xoa, Ias, Ias, Ias, Xoa, Xoa, Ias, Xoa, Xoa, Ias, Ias, Uu, Ias, Ias, Xoa, Xoa, Xoa, Ias, Ias, Ias, Xoa, Ias, Cud, Ias, Ias, Ias, Cud, Xoa, Ias, Ias, Ias, Ias, Ias, Xoa, Xoa, Xv
Xv, Xoa, Xoa, Ias, Ias, Ias, Ias, Xoa, Ias, Ias, Ias, Uu, Uu, Uu, Uu, Ias, Xoa, Ias, Ias, Cud, Ias, Xoa, Xoa, Ias, Xoa, Ias, Ias, Xoa, Ias, Ias, Cud, Ias, Xoa, Xoa, Xv, Xv, Xv
Xv, Xv, Xv, Xoa, Ias, Cud, Ias, Ias, Cud, Ias, Xoa, Ias, Ias, Uu, Ias, Ias, Ias^Pr/, Xoa, Xoa, Ias, Ias, Ias, Ias, Xoa, Ias, Ias, Cud, Ias, Ias, Ias, Ias, Ias, Xoa, Xv, Xv, Xv, Xv
Xv, Xv, Xv, Xoa, Xoa, Ias, Xoa, Ias, Ias, Ias, Ias, Xoa, Xoa, Ias, Xoa, Ias^Pr/, Ias, Ias, Cud, Cud, Cud, Ias, Ias, Ias, Ias, Ias, Ias, Ias, Ias^Pr/, Xoa, Xoa, Xoa, Xv, Xv, Xv, Xv, Xv
Xv, Xv, Xv, Xv, Xv, Xoa, Xv, Xoa, Xoa, Ias, Cud, Ias, Ias, Xoa, Ias, Xoa, Ias^Pr\, Ias, Ias, Cud^Vud, Xoa, Xoa, Ias, Cud, Ias, Xoa, Xoa, Ias^Pr/, Ias, Ias, Ias, Xoa, Xv, Xv, Xv, Xv, Xv
Xv, Xv, Xv, Xv, Xv, Xv, Xv, Xv, Xoa, Ias, Ias, Ias, Ias, Ias, Ias, Ias, Ias, Ias^Pr\, Xoa, Xoa, Xoa, Ias, Ias, Ias, Ias, Ias, Xoa, Xoa, Xoa, Ias, Xoa, Xoa, Xv, Xv, Xv, Xv, Xv
Xv, Xv, Xv, Xv, Xv, Xv, Xv, Xv, Xv, Xoa, Xoa, Xoa, Xoa, Ias, Xoa, Ias, Xoa, Xoa, Xv, Xv, Xv, Xoa, Xoa, Xoa, Xoa, Xoa, Xv, Xv, Xv, Xoa, Xv, Xv, Xv, Xv, Xv, Xv, Xv
Xv, Xv, Xv, Xv, Xv, Xv, Xv, Xv, Xv, Xv, Xv, Xv, Xv, Xoa, Gg, Xoa, Xv, Xv, Xv, Xv, Xv, Xv, Xv, Xv, Xv, Xv, Xv, Xv, Xv, Xv, Xv, Xv, Xv, Xv, Xv, Xv, Xv
