Xv, Xv, Xv, Xv, Xv, Xv, Xv, Xv, Xv, Xv, Xv, Xv, Xv, Xv, Xv, Xv, Xv, Xv, Xv, Xv, Xv, Xv, Xv, Xv, Xv, Xv, Xv, Xv, Xv, Xv, Xv, Xv, Xv, Xv, Xv, Xv, Xv
Xv, Xv, Xv, Xv, Xv, Xv, Xv, Xv, Xv, Xv, Xv, Xv, Xv, Xv, Xoa, Xv, Xv, Xv, Xv, Xv, Xv, Xv, Xoa, Xoa, Xoa, Xv, Xv, Xv, Xoa, Xv, Xv, Xv, Xv, Xv, Xv, Xv, Xv
Xv, Xv, Xv, Xv, Xv, Xv, Xv, Xv, Xoa, Xv, Xv, Xv, Xoa, Xoa, Uu, Xoa, Xoa, Xv, Xoa, Xoa, Xoa, Xoa, Isa, Isa, Isa, Xoa, Xoa, Xoa, Uu, Xoa, Xoa, Xv, Xv, Xv, Xv, Xv, Xv
Xv, Xv, Xv, Xv, Xoa, Xoa, Xoa, Xoa, Isa, Xoa, Xoa, Xoa, Isa, Isa, Isa, Uu, Uu, Xoa, Isa, Isa, Isa^Pr/, Xoa, Xoa, Isa, Isa^Pr/, Xoa, Isa^Pr\, Uu, Uu, Uu, Xoa, Xoa, Xoa, Xv, Xv, Xv, Xv
Xv, Xv, Xoa, Xoa, Isa, Isa, Isa, Isa^Pr\, Isa^Pr\, Isa, Xoa, Isa, Ur, Ur, Ur, Isa, Uu, Xoa, Xoa, Isa^Pr/, Isa, Isa, Xoa, Isa^Pr/, Isa, Isa, Isa, Isa^Pr\, Xoa, Xoa, Uu, Uu, Uu, Xoa, Xv, Xv, Xv
Xv, Xv, Xoa, Isa, Isa, Cud, Isa, Isa, Xoa, Xoa, Isa, Isa, Ur, Ur, Ur, Isa, Xoa, Xoa, Isa^Pr\, Isa, Isa, Cud, Isa, Isa, Urb, Urb, Urb, Isa, Isa, Isa^Pr\, Isa^Pr\, Uu, Xoa, Xoa, Xoa, Xv, Xv
Xv, Xoa, Xoa, Xoa, Xoa, Isa, Isa^Pr/, Isa^Pr/, Isa, Isa, Isa, Isa, Isa, Ur, Isa, Isa, Xoa, Isa, Isa, Isa^Pr\, Xoa, Isa, Isa, Urb^Vud, Urb, Cud, Urb, Urb^Vud, Urb, Isa, Isa, Xoa, Isa, Isa, Xoa, Xv, Xv
Xv, Xoa, Isa, Isa, Xoa, Xoa, Isa, Isa, Isa, Isa, Cud, Xoa, Xoa, Isa, Xoa, Xoa, Isa, Xoa, Xoa, Xoa, Isa, Isa^Pr\, Isa^Pr\, Isa, Isa, Urb, Urb, Urb, Cud, Urb, Isa, Xoa, Isa, Isa, Isa, Xoa, Xv
Xv, Xoa, Isa^Pr/, Isa^Pr/, Isa, Isa, Isa, Isa, Xoa, Cud, Cud^Vud, Cud, Isa, Xoa, Isa, Isa, Ur, Isa, Isa, Xoa, Xoa, Isa, Xoa, Xoa, Isa^Pr\, Isa, Isa, Urb, Isa, Isa, Xoa, Xoa, Isa^Pr\, Isa, Isa, Xoa, Xv
Xv, Xoa, Isa, Isa, Isa, Cud, Isa, Xoa, Isa, Cud, Cud, Cud, Isa, Xoa, Isa, Ur, 1 Ur, Ur, Isa, Xoa, Isa, Xoa, Xoa, Isa, Isa, Isa^Pr\, Xoa, Isa, Isa, Xoa, Isa, Isa, Isa, Isa^Pr\, Xoa, Xoa, Xv
Xv, Xoa, Isa, Isa, Xoa, Isa, Xoa, Xoa, Isa^Pr\, Isa, Isa, Isa, Isa, Xoa, Isa, Ur, Ur, Ur, Isa, Isa, Cud, Isa, Isa, Xoa, Xoa, Xoa, Isa, Isa, Isa, Xoa, Isa, Cud, Cud, Isa, Isa, Xoa, Xv
Xv, Xoa, Isa, Isa, Xoa, Xoa, Isa, Isa, Isa, Isa^Pr\, Xoa, Isa, Isa, Xoa, Xoa, Isa, Isa, Isa, Xoa, Isa, Isa, Isa, Isa, Isa, Isa, Isa, Isa, Isa, Xoa, Xoa, Isa, Cud, Cud, Cud, Isa, Xoa, Xv
Xv, Xoa, Isa, Isa, Isa, Xoa, Xoa, Isa, Xoa, Xoa, Isa, Isa, Uu, Isa, Isa, Xoa, Xoa, Xoa, Isa, Isa, Isa, Xoa, Isa, Cud, Isa, Isa, Isa, Cud, Xoa, Isa, Isa, Isa, Isa, Isa, Xoa, Xoa, Xv
Xv, Xoa, Xoa, Isa, Isa, Isa, Isa, Xoa, Isa, Isa, Isa, Uu, Uu, Uu, Uu, Isa, Xoa, Isa, Isa, Cud, Isa, Xoa, Xoa, Isa, Xoa, Isa, Isa, Xoa, Isa, Isa, Cud, Isa, Xoa, Xoa, Xv, Xv, Xv
Xv, Xv, Xv, Xoa, Isa, Cud, Isa, Isa, Cud, Isa, Xoa, Isa, Isa, Uu, Isa, Isa, Isa^Pr/, Xoa, Xoa, Isa, Isa, Isa, Isa, Xoa, Isa, Isa, Cud, Isa, Isa, Isa, Isa, Isa, Xoa, Xv, Xv, Xv, Xv
Xv, Xv, Xv, Xoa, Xoa, Isa, Xoa, Isa, Isa, Isa, Isa, Xoa, Xoa, Isa, Xoa, Isa^Pr/, Isa, Isa, Cud, Cud, Cud, Isa, Isa, Isa, Isa, Isa, Isa, Isa, Isa^Pr/, Xoa, Xoa, Xoa, Xv, Xv, Xv, Xv, Xv
Xv, Xv, Xv, Xv, Xv, Xoa, Xv, Xoa, Xoa, Isa, Cud, Isa, Isa, Xoa, Isa, Xoa, Isa^Pr\, Isa, Isa, Cud^Vud, Xoa, Xoa, Isa, Cud, Isa, Xoa, Xoa, Isa^Pr/, Isa, Isa, Isa, Xoa, Xv, Xv, Xv, Xv, Xv
Xv, Xv, Xv, Xv, Xv, Xv, Xv, Xv, Xoa, Isa, Isa, Isa, Isa, Isa, Isa, Isa, Isa, Isa^Pr\, Xoa, Xoa, Xoa, Isa, Isa, Isa, Isa, Isa, Xoa, Xoa, Xoa, Isa, Xoa, Xoa, Xv, Xv, Xv, Xv, Xv
Xv, Xv, Xv, Xv, Xv, Xv, Xv, Xv, Xv, Xoa, Xoa, Xoa, Xoa, Isa, Xoa, Isa, Xoa, Xoa, Xv, Xv, Xv, Xoa, Xoa, Xoa, Xoa, Xoa, Xv, Xv, Xv, Xoa, Xv, Xv, Xv, Xv, Xv, Xv, Xv
Xv, Xv, Xv, Xv, Xv, Xv, Xv, Xv, Xv, Xv, Xv, Xv, Xv, Xoa, Gg, Xoa, Xv, Xv, Xv, Xv, Xv, Xv, Xv, Xv, Xv, Xv, Xv, Xv, Xv, Xv, Xv, Xv, Xv, Xv, Xv, Xv, Xv
