Xv, Xv, Xv, Xv, Xv, Xv, Xv, Xv, Xv, Xv, Xv, Xv, Xv, Xv, Xv, Xv, Xv, Xv, Xv, Xv, Xv, Xv, Xv, Xv, Xv, Xv, Xv, Xv, Xv, Xv, Xv, Xv, Xv, Xv, Xv, Xv, Xv
Xv, Xv, Xv, Xv, Xv, Xv, Xv, Xv, Xv, Xv, Xv, Xv, Xv, Xv, Xoa, Xv, Xv, Xv, Xv, Xv, Xv, Xv, Xoa, Xoa, Xoa, Xv, Xv, Xv, Xoa, Xv, Xv, Xv, Xv, Xv, Xv, Xv, Xv
Xv, Xv, Xv, Xv, Xv, Xv, Xv, Xv, Xoa, Xv, Xv, Xv, Xoa^Efs, Xoa, Xoa^Efs, Xoa, Xoa, Xv, Xoa^Efs, Xoa, Xoa^Efs, Xoa, Xoa, Xoa^Efs, Isa, Xoa, Xoa^Efs, Xoa, Cud, Xoa^Efs, Xoa, Xv, Xv, Xv, Xv, Xv, Xv
Xv, Xv, Xv, Xv, Xoa, Xoa^Efs, Xoa, Xoa, Uu, Xoa^Efs, Xoa, Xoa, Isa, Isa, Isa, Xoa, Xoa, Xoa, Isa, Isa, Isa, Xoa, Xoa, Isa, Isa^Pr/, Xoa, Uu, Isa, Isa, Uu, Uu^Vud, Xoa^Efs, Xoa, Xv, Xv, Xv, Xv
Xv, Xv, Xoa, Xoa, Xoa, Isa, Isa^Pr/, Xoa, Isa^Pr\, Uu, Xoa, Isa, Ur, Ur, Ur, Isa, Xoa, Isa, Ur, Ur, Ur, Isa, Xoa, Xoa, Xoa, Isa, Isa, Uu, Isa, Isa, Uu, Isa, Cud, Xoa, Xv, Xv, Xv
Xv, Xv, Xoa, Xoa, Isa, Xoa, Uu, Uu, Isa, Xoa, Xoa, Isa, Ur, Ur, Ur, Isa, Xoa, Isa, Ur, 1 Ur, Ur, Isa, Xoa, Xoa^Efs, Uu, Xoa, Isa^Pr\, Isa, Isa, Isa, Isa, Isa, Xoa, Xoa, Xoa, Xv, Xv
Xv, Xoa, Isa, Isa, Ur, Isa, Isa, Cud, Xoa, Xoa^Efs, Uu, Isa, Isa, Ur, Isa, Isa, Xoa, Isa, Isa, Ur, Isa, Isa, Isa, Uu, Isa, Isa, Isa, Isa^Pr\, Xoa^Efs, Cud, Xoa, Xoa, Isa^Pr\, Isa, Xoa, Xv, Xv
Xv, Xoa, Isa, Ur, Ur, Ur, Isa, Xoa, Uu, Uu, Uu, Isa, Xoa, Isa, Isa^Pr/, Xoa, Isa, Xoa^Efs, Xoa, Isa, Uu, Isa, Isa, Isa, Xoa^Efs, Isa, Uu, Isa, Isa, Xoa, Uu, Isa, Isa, Xoa^Efs, Xoa, Xoa, Xv
Xv, Xoa, Isa, Ur, Ur, Ur, Isa, Isa, Uu, Isa, Cud, Cud, Xoa^Efs, Isa^Pr/, Isa, Isa, Ur, Isa, Isa, Xoa, Xoa, Uu, Xoa, Xoa, Uu, Isa^Pr\, Xoa, Uu, Isa, Isa, Isa, Uu, Isa, Uu, Cud, Xoa, Xv
Xv, Xoa, Xoa, Isa, Isa, Isa, Uu, Cud, Isa, Xoa, Xoa, Xoa, Isa, Xoa, Isa, Ur, Ur, Ur, Isa, Xoa, Xoa^Efs, Xoa, Xoa^Efs, Isa, Xoa^Efs, Xoa, Cud, Xoa^Efs, Xoa, Cud, Xoa, Xoa^Efs, Isa^Pr\, Isa, Isa, Xoa, Xv
Xv, Xoa, Uu, Isa^Pr\, Xoa, Uu, Xoa, Isa, Isa^Pr/, Isa^Pr/, Isa, Isa^Pr\, Xoa, Xoa, Isa, Ur, Ur, Ur, Isa, Xoa, Isa, Uu, Isa^Pr/, Xoa, Uu, Isa, Isa, Isa, Isa^Pr/, Xoa, Cud, Isa, Isa, Isa^Pr\, Xoa^Efs, Xoa, Xv
Xv, Xoa, Xoa, Isa, Xoa, Xoa, Uu, Xoa^Efs, Xoa, Isa, Cud, Isa, Xoa^Efs, Xoa, Isa^Pr\, Isa, Isa, Isa, Isa^Pr/, Xoa, Xoa^Efs, Isa^Pr/, Isa, Isa, Uu, Uu, Xoa^Efs, Isa^Pr/, Uu, Isa, Isa, Uu, Uu^Vud, Isa, Cud, Xoa, Xv
Xv, Xoa, Isa, Xoa^Efs, Xoa, Cud, Uu, Uu, Uu^Vud, Xoa, Xoa, Xoa, Isa, Uu, Isa, Isa^Pr\, Xoa, Isa^Pr/, Isa, Isa, Uu, Xoa, Xoa, Cud, Cud, Isa, Isa, Xoa, Xoa, Isa, Isa, Uu, Isa, Isa, Xoa, Xoa, Xv
Xv, Xoa, Xoa, Uu, Isa^Pr/, Xoa, Isa^Pr\, Isa, Isa, Xoa^Efs, Xoa, Cud, Isa, Uu, Xoa, Isa^Pr/, Isa, Xoa^Efs, Xoa, Uu, Uu, Isa, Cud, Xoa^Efs, Xoa, Isa, Isa^Pr/, Isa^Pr/, Uu, Xoa^Efs, Xoa, Cud, Xoa, Xoa, Xv, Xv, Xv
Xv, Xv, Xv, Xoa, Xoa, Isa, Isa^Pr/, Xoa^Efs, Xoa, Isa, Isa^Pr/, Xoa, Xoa, Isa^Pr/, Uu, Xoa^Efs, Xoa, Uu, Xoa, Xoa^Efs, Isa, Isa, Uu, Isa, Isa^Pr/, Xoa, Isa, Isa, Cud, Isa, Isa, Xoa, Xoa, Xv, Xv, Xv, Xv
Xv, Xv, Xv, Xoa, Xoa, Xoa, Xoa, Uu, Isa, Xoa, Xoa, Isa, Isa, Isa, Uu, Uu, Xoa, Xoa^Efs, Uu, Isa, Isa, Uu, Xoa, Isa^Pr/, Isa, Uu, Cud, Isa, Uu, Uu, Isa, Xoa, Xv, Xv, Xv, Xv, Xv
Xv, Xv, Xv, Xv, Xv, Xoa, Xv, Xoa, Xoa, Xoa, Isa^Pr\, Uu, Isa, Cud, Isa, Xoa, Isa^Pr\, Uu, Uu, Isa, Isa^Pr/, Xoa, Xoa, Xoa, Xoa^Efs, Uu, Isa, Isa, Isa, Uu^Vud, Isa, Xoa, Xv, Xv, Xv, Xv, Xv
Xv, Xv, Xv, Xv, Xv, Xv, Xv, Xv, Xoa, Uu, Isa, Isa^Pr\, Xoa, Isa, Isa, Isa, Isa, Isa^Pr\, Xoa, Xoa, Xoa, Isa, Isa, Isa, Isa, Xoa, Xoa, Xoa, Xoa, Isa, Xoa, Xoa, Xv, Xv, Xv, Xv, Xv
Xv, Xv, Xv, Xv, Xv, Xv, Xv, Xv, Xv, Xoa, Xoa, Xoa, Xoa, Xoa, Xoa, Isa, Xoa, Xoa, Xv, Xv, Xv, Xoa, Xoa, Xoa, Xoa, Xoa, Xv, Xv, Xv, Xoa, Xv, Xv, Xv, Xv, Xv, Xv, Xv
Xv, Xv, Xv, Xv, Xv, Xv, Xv, Xv, Xv, Xv, Xv, Xv, Xv, Xoa, Gg, Xoa, Xv, Xv, Xv, Xv, Xv, Xv, Xv, Xv, Xv, Xv, Xv, Xv, Xv, Xv, Xv, Xv, Xv, Xv, Xv, Xv, Xv
