Xv, Xv, Xv, Xv, Xv, Xv, Xv, Xv, Xv, Xv, Xv, Xv, Xv, Xv, Xv, Xv, Xv, Xv, Xv, Xv, Xv, Xv, Xv, Xv, Xv, Xv, Xv, Xv, Xv, Xv, Xv, Xv, Xv, Xv, Xv, Xv, Xv
Xv, Xv, Xv, Xv, Xv, Xv, Xv, Xv, Xv, Xv, Xv, Xv, Xv, Xv, Xoa, Xv, Xv, Xv, Xv, Xv, Xv, Xv, Xoa, Xoa, Xoa, Xv, Xv, Xv, Xoa, Xv, Xv, Xv, Xv, Xv, Xv, Xv, Xv
Xv, Xv, Xv, Xv, Xv, Xv, Xv, Xv, Xoa, Xv, Xv, Xv, Xoa, Xoa, Xoa, Xoa, Xoa, Xv, Xoa, Xoa, Xoa, Xoa, Urb, Urb, Urb, Xoa, Xoa, Xoa, Urb, Xoa, Xoa, Xv, Xv, Xv, Xv, Xv, Xv
Xv, Xv, Xv, Xv, Xoa, Xoa, Xoa, Xoa, Urb, Xoa, Xoa, Xoa, Ias, Ias, Ias, Xoa, Xoa, Xoa, Ias, Xoa, Ias^Pr\, Urb, Urb, Urb, Urb, Urb, Urb, Urb, Urb, Urb, Urb, Xoa, Xoa, Xv, Xv, Xv, Xv
Xv, Xv, Xoa, Xoa, Urb, Urb, Urb, Urb, Urb, Urb, Xoa, Ias, Ur, Ur, Ur, Ias, Xoa, Ias, Ias, Ias, Ias, Ias^Pr\, Xoa, Urb, Urb, Urb, Urb, Urb, Urb, Urb, Urb, Urb, Urb, Xoa, Xv, Xv, Xv
Xv, Xv, Xoa, Urb, Urb, Urb, Urb, Urb, Urb, Urb, Xoa, Ias, Ur, 1 Ur, Ur, Ias, Xoa, Xoa, Ias^Pr\, Ias, Ias, Ias, Xoa, Xoa, Xoa, Urb, Urb, Urb, Urb, Urb, Xoa, Urb, Ias^Pr/, Xoa, Xoa, Xv, Xv
Xv, Xoa, Xoa, Urb, Urb, Urb, Urb, Urb, Urb, Urb, Xoa, Ias, Ias, Ur, Ias, Ias, Xoa, Ias, Ias, Ias^Pr\, Xoa, Xoa, Xoa, Xoa, Ias^Pr\, Urb, Urb, Urb, Xoa, Xoa, Ias, Xoa, Xoa, Ias, Xoa, Xv, Xv
Xv, Xoa, Xoa, Xoa, Ias^Pr\, Urb, Urb, Urb, Xoa, Xoa, Ias, Xoa, Xoa, Ias, Ias, Ias, Ias, Xoa, Xoa, Xoa, Ias, Ias, Ias, Ias, Ias, Ias^Pr\, Xoa, Xoa, Ias, Xoa, Xoa, Ias^Pr/, Ias, Ias, Xoa, Xoa, Xv
Xv, Xoa, Ias, Ias, Ias, Ias^Pr\, Xoa, Xoa, Ias, Ias, Ias, Ias, Ias, Xoa, Xoa, Ias, Ias, Ias, Ias, Ias^Pr\, Ias^Pr\, Ias, Ias, Ias, Ias, Ias, Ias, Ias^Pr\, Xoa, Xoa, Ias, Xoa, Xoa, Ias^Pr/, Ias, Xoa, Xv
Xv, Xoa, Xoa, Ias, Ias, Ias, Ias, Ias^Pr\, Ias^Pr\, Ias, Ias, Ias, Ias, Ias, Xoa, Xoa, Ias, Ias, Ias, Ias, Xoa, Xoa, Xoa, Ias, Ias, Ias, Ias, Xoa, Xoa, Ias, Xoa, Ias^Pr/, Urb, Xoa, Xoa, Xoa, Xv
Xv, Xoa, Xoa, Xoa, Xuc, Ias, Ias, Ias, Ias, Xoa, Xoa, Ias, Xoa, Xoa, Ias, Ias^Pr\, Ias^Pr\, Ias, Ias, Ias, Ias, Xoa, Ias, Ias^Pr\, Xoa, Ias, Ias, Ias, Ias^Pr/, Xoa, Xoa, Urb, Urb, Urb, Urb, Xoa, Xv
Xv, Xoa, Ior, Ior, Ior, Xoa, Xoa, Ias, Ias, Ias, Ias^Pr/, Xoa, Ias, Ias, Ias, Ias, Xoa, Xoa, Xoa, Ias, Ias, Xoa, Xoa, Xoa, Ias, Xoa, Xoa, Ias^Pr/, Urb, Urb, Urb, Urb, Urb, Urb, Urb, Xoa, Xv
Xv, Xoa, Xoa, Ior, Ior, Ior, Xoa, Xoa, Xoa, Ias^Pr/, Ias, Ias, Ias, Ias, Xoa, Xoa, Ias, Ias, Xoa, Ias, Ias, Xoa, Ias, Ias, Ias^Pr/, Xoa, Urb, Xoa, Urb, Urb, Urb, Urb, Urb, Urb, Xoa, Xoa, Xv
Xv, Xoa, Xoa, Xoa, Xoa, Xoa, Ias, Ias, Ias, Xoa, Xoa, Ias, Ias^Pr/, Ias^Pr/, Urb, Ias^Pr\, Xoa, Xoa, Ias, Ias, Ias, Xoa, Xoa, Xoa, Urb, Urb, Urb, Urb, Urb, Urb, Urb, Urb, Xoa, Xoa, Xv, Xv, Xv
Xv, Xv, Xv, Xoa, Ias, Ias, Ias, Ias, Xoa, Xoa, Urb, Xoa, Xoa, Urb, Urb, Urb, Xoa, Ias, Ur, Ur, Ur, Ias, Xoa, Urb, Urb, Urb, Urb, Urb, Urb, Urb, Urb, Urb, Xoa, Xv, Xv, Xv, Xv
Xv, Xv, Xv, Xoa, Xoa, Ias, Xoa, Ias^Pr/, Urb, Urb, Urb, Urb, Urb, Xoa, Urb, Urb, Xoa, Ias, Ur, Ur, Ur, Ias, Xoa, Xoa, Ias^Pr\, Urb, Urb, Urb, Urb, Urb, Xoa, Xoa, Xv, Xv, Xv, Xv, Xv
Xv, Xv, Xv, Xv, Xv, Xoa, Xv, Xoa, Xoa, Urb, Xoa, Urb, Urb, Urb, Urb, Urb, Xoa, Ias, Ias, Ur, Ias, Ias, Xoa, Ias, Ias, Xoa, Xoa, Urb, Xoa, Ias^Pr/, Ias, Xoa, Xv, Xv, Xv, Xv, Xv
Xv, Xv, Xv, Xv, Xv, Xv, Xv, Xv, Xoa, Urb, Urb, Xoa, Urb, Xoa, Xoa, Urb, Urb, Xoa, Xoa, Xoa, Xoa, Xoa, Xoa, Ias, Ias, Ias, Xoa, Xoa, Xoa, Ias, Xoa, Xoa, Xv, Xv, Xv, Xv, Xv
Xv, Xv, Xv, Xv, Xv, Xv, Xv, Xv, Xv, Xoa, Xoa, Xoa, Xoa, Urb, Xoa, Urb, Xoa, Xoa, Xv, Xv, Xv, Xoa, Xoa, Xoa, Xoa, Xoa, Xv, Xv, Xv, Xoa, Xv, Xv, Xv, Xv, Xv, Xv, Xv
Xv, Xv, Xv, Xv, Xv, Xv, Xv, Xv, Xv, Xv, Xv, Xv, Xv, Xoa, Gg, Xoa, Xv, Xv, Xv, Xv, Xv, Xv, Xv, Xv, Xv, Xv, Xv, Xv, Xv, Xv, Xv, Xv, Xv, Xv, Xv, Xv, Xv
