Xv, Xv, Xv, Xv, Xv, Xv, Xv, Xv, Xv, Xv, Xv, Xv, Xv, Xv, Xv, Xv, Xv, Xv, Xv, Xv, Xv, Xv, Xv, Xv, Xv, Xv, Xv, Xv, Xv, Xv, Xv, Xv, Xv, Xv, Xv, Xv, Xv
Xv, Xv, Xv, Xv, Xv, Xv, Xv, Xv, Xv, Xv, Xv, Xv, Xv, Xv, Xoa, Xv, Xv, Xv, Xv, Xv, Xv, Xv, Xoa, Xoa, Xoa, Xv, Xv, Xv, Xoa, Xv, Xv, Xv, Xv, Xv, Xv, Xv, Xv
Xv, Xv, Xv, Xv, Xv, Xv, Xv, Xv, Xoa, Xv, Xv, Xv, Xoa^Efs, Xoa, Xoa^Efs, Xoa, Xoa, Xv, Xoa^Efs, Xoa, Xoa^Efs, Xoa, Xoa, Xoa^Efs, Ias, Xoa, Xoa^Efs, Xoa, Cud, Xoa^Efs, Xoa, Xv, Xv, Xv, Xv, Xv, Xv
Xv, Xv, Xv, Xv, Xoa, Xoa^Efs, Xoa, Xoa, Uu, Xoa^Efs, Xoa, Xoa, Ias, Ias, Ias, Xoa, Xoa, Xoa, Ias, Ias, Ias, Xoa, Xoa, Ias, Ias^Pr/, Xoa, Uu, Ias, Ias, Uu, Uu^Vud, Xoa^Efs, Xoa, Xv, Xv, Xv, Xv
Xv, Xv, Xoa, Xoa, Xoa, Ias, Ias^Pr/, Xoa, Ias^Pr\, Uu, Xoa, Ias, Ur, Ur, Ur, Ias, Xoa, Ias, Ur, Ur, Ur, Ias, Xoa, Xoa, Xoa, Ias, Ias, Uu, Ias, Ias, Uu, Ias, Cud, Xoa, Xv, Xv, Xv
Xv, Xv, Xoa, Xoa, Ias, Xoa, Uu, Uu, Ias, Xoa, Xoa, Ias, Ur, Ur, Ur, Ias, Xoa, Ias, Ur, 1 Ur, Ur, Ias, Xoa, Xoa^Efs, Uu, Xoa, Ias^Pr\, Ias, Ias, Ias, Ias, Ias, Xoa, Xoa, Xoa, Xv, Xv
Xv, Xoa, Ias, Ias, Ur, Ias, Ias, Cud, Xoa, Xoa^Efs, Uu, Ias, Ias, Ur, Ias, Ias, Xoa, Ias, Ias, Ur, Ias, Ias, Ias, Uu, Ias, Ias, Ias, Ias^Pr\, Xoa^Efs, Cud, Xoa, Xoa, Ias^Pr\, Ias, Xoa, Xv, Xv
Xv, Xoa, Ias, Ur, Ur, Ur, Ias, Xoa, Uu, Uu, Uu, Ias, Xoa, Ias, Ias^Pr/, Xoa, Ias, Xoa^Efs, Xoa, Ias, Uu, Ias, Ias, Ias, Xoa^Efs, Ias, Uu, Ias, Ias, Xoa, Uu, Ias, Ias, Xoa^Efs, Xoa, Xoa, Xv
Xv, Xoa, Ias, Ur, Ur, Ur, Ias, Ias, Uu, Ias, Cud, Cud, Xoa^Efs, Ias^Pr/, Ias, Ias, Ur, Ias, Ias, Xoa, Xoa, Uu, Xoa, Xoa, Uu, Ias^Pr\, Xoa, Uu, Ias, Ias, Ias, Uu, Ias, Uu, Cud, Xoa, Xv
Xv, Xoa, Xoa, Ias, Ias, Ias, Uu, Cud, Ias, Xoa, Xoa, Xoa, Ias, Xoa, Ias, Ur, Ur, Ur, Ias, Xoa, Xoa^Efs, Xoa, Xoa^Efs, Ias, Xoa^Efs, Xoa, Cud, Xoa^Efs, Xoa, Cud, Xoa, Xoa^Efs, Ias^Pr\, Ias, Ias, Xoa, Xv
Xv, Xoa, Uu, Ias^Pr\, Xoa, Uu, Xoa, Ias, Ias^Pr/, Ias^Pr/, Ias, Ias^Pr\, Xoa, Xoa, Ias, Ur, Ur, Ur, Ias, Xoa, Ias, Uu, Ias^Pr/, Xoa, Uu, Ias, Ias, Ias, Ias^Pr/, Xoa, Cud, Ias, Ias, Ias^Pr\, Xoa^Efs, Xoa, Xv
Xv, Xoa, Xoa, Ias, Xoa, Xoa, Uu, Xoa^Efs, Xoa, Ias, Cud, Ias, Xoa^Efs, Xoa, Ias^Pr\, Ias, Ias, Ias, Ias^Pr/, Xoa, Xoa^Efs, Ias^Pr/, Ias, Ias, Uu, Uu, Xoa^Efs, Ias^Pr/, Uu, Ias, Ias, Uu, Uu^Vud, Ias, Cud, Xoa, Xv
Xv, Xoa, Ias, Xoa^Efs, Xoa, Cud, Uu, Uu, Uu^Vud, Xoa, Xoa, Xoa, Ias, Uu, Ias, Ias^Pr\, Xoa, Ias^Pr/, Ias, Ias, Uu, Xoa, Xoa, Cud, Cud, Ias, Ias, Xoa, Xoa, Ias, Ias, Uu, Ias, Ias, Xoa, Xoa, Xv
Xv, Xoa, Xoa, Uu, Ias^Pr/, Xoa, Ias^Pr\, Ias, Ias, Xoa^Efs, Xoa, Cud, Ias, Uu, Xoa, Ias^Pr/, Ias, Xoa^Efs, Xoa, Uu, Uu, Ias, Cud, Xoa^Efs, Xoa, Ias, Ias^Pr/, Ias^Pr/, Uu, Xoa^Efs, Xoa, Cud, Xoa, Xoa, Xv, Xv, Xv
Xv, Xv, Xv, Xoa, Xoa, Ias, Ias^Pr/, Xoa^Efs, Xoa, Ias, Ias^Pr/, Xoa, Xoa, Ias^Pr/, Uu, Xoa^Efs, Xoa, Uu, Xoa, Xoa^Efs, Ias, Ias, Uu, Ias, Ias^Pr/, Xoa, Ias, Ias, Cud, Ias, Ias, Xoa, Xoa, Xv, Xv, Xv, Xv
Xv, Xv, Xv, Xoa, Xoa, Xoa, Xoa, Uu, Ias, Xoa, Xoa, Ias, Ias, Ias, Uu, Uu, Xoa, Xoa^Efs, Uu, Ias, Ias, Uu, Xoa, Ias^Pr/, Ias, Uu, Cud, Ias, Uu, Uu, Ias, Xoa, Xv, Xv, Xv, Xv, Xv
Xv, Xv, Xv, Xv, Xv, Xoa, Xv, Xoa, Xoa, Xoa, Ias^Pr\, Uu, Ias, Cud, Ias, Xoa, Ias^Pr\, Uu, Uu, Ias, Ias^Pr/, Xoa, Xoa, Xoa, Xoa^Efs, Uu, Ias, Ias, Ias, Uu^Vud, Ias, Xoa, Xv, Xv, Xv, Xv, Xv
Xv, Xv, Xv, Xv, Xv, Xv, Xv, Xv, Xoa, Uu, Ias, Ias^Pr\, Xoa, Ias, Ias, Ias, Ias, Ias^Pr\, Xoa, Xoa, Xoa, Ias, Ias, Ias, Ias, Xoa, Xoa, Xoa, Xoa, Ias, Xoa, Xoa, Xv, Xv, Xv, Xv, Xv
Xv, Xv, Xv, Xv, Xv, Xv, Xv, Xv, Xv, Xoa, Xoa, Xoa, Xoa, Xoa, Xoa, Ias, Xoa, Xoa, Xv, Xv, Xv, Xoa, Xoa, Xoa, Xoa, Xoa, Xv, Xv, Xv, Xoa, Xv, Xv, Xv, Xv, Xv, Xv, Xv
Xv, Xv, Xv, Xv, Xv, Xv, Xv, Xv, Xv, Xv, Xv, Xv, Xv, Xoa, Gg, Xoa, Xv, Xv, Xv, Xv, Xv, Xv, Xv, Xv, Xv, Xv, Xv, Xv, Xv, Xv, Xv, Xv, Xv, Xv, Xv, Xv, Xv
