Xv, Xv, Xv, Xv, Xv, Xv, Xv, Xv, Xv, Xv, Xv, Xv, Xv, Xv, Xv, Xv, Xv, Xv, Xv, Xv, Xv, Xv, Xv, Xv, Xv, Xv, Xv, Xv, Xv, Xv, Xv, Xv, Xv, Xv, Xv, Xv, Xv
Xv, Xv, Xv, Xv, Xv, Xv, Xv, Xv, Xv, Xv, Xv, Xv, Xv, Xv, Xoa, Xv, Xv, Xv, Xv, Xv, Xv, Xv, Xoa, Xoa, Xoa, Xv, Xv, Xv, Xoa, Xv, Xv, Xv, Xv, Xv, Xv, Xv, Xv
Xv, Xv, Xv, Xv, Xv, Xv, Xv, Xv, Xoa, Xv, Xv, Xv, Xoa, Xoa, Xoa, Xoa, Xoa, Xv, Xoa, Xoa, Xoa, Xoa, Urb, Urb, Urb, Xoa, Xoa, Xoa, Urb, Xoa, Xoa, Xv, Xv, Xv, Xv, Xv, Xv
Xv, Xv, Xv, Xv, Xoa, Xoa, Xoa, Xoa, Urb, Xoa, Xoa, Xoa, Isa, Isa, Isa, Xoa, Xoa, Xoa, Isa, Xoa, Isa^Pr\, Urb, Urb, Urb, Urb, Urb, Urb, Urb, Urb, Urb, Urb, Xoa, Xoa, Xv, Xv, Xv, Xv
Xv, Xv, Xoa, Xoa, Urb, Urb, Urb, Urb, Urb, Urb, Xoa, Isa, Ur, Ur, Ur, Isa, Xoa, Isa, Isa, Isa, Isa, Isa^Pr\, Xoa, Urb, Urb, Urb, Urb, Urb, Urb, Urb, Urb, Urb, Urb, Xoa, Xv, Xv, Xv
Xv, Xv, Xoa, Urb, Urb, Urb, Urb, Urb, Urb, Urb, Xoa, Isa, Ur, 1 Ur, Ur, Isa, Xoa, Xoa, Isa^Pr\, Isa, Isa, Isa, Xoa, Xoa, Xoa, Urb, Urb, Urb, Urb, Urb, Xoa, Urb, Isa^Pr/, Xoa, Xoa, Xv, Xv
Xv, Xoa, Xoa, Urb, Urb, Urb, Urb, Urb, Urb, Urb, Xoa, Isa, Isa, Ur, Isa, Isa, Xoa, Isa, Isa, Isa^Pr\, Xoa, Xoa, Xoa, Xoa, Isa^Pr\, Urb, Urb, Urb, Xoa, Xoa, Isa, Xoa, Xoa, Isa, Xoa, Xv, Xv
Xv, Xoa, Xoa, Xoa, Isa^Pr\, Urb, Urb, Urb, Xoa, Xoa, Isa, Xoa, Xoa, Isa, Isa, Isa, Isa, Xoa, Xoa, Xoa, Isa, Isa, Isa, Isa, Isa, Isa^Pr\, Xoa, Xoa, Isa, Xoa, Xoa, Isa^Pr/, Isa, Isa, Xoa, Xoa, Xv
Xv, Xoa, Isa, Isa, Isa, Isa^Pr\, Xoa, Xoa, Isa, Isa, Isa, Isa, Isa, Xoa, Xoa, Isa, Isa, Isa, Isa, Isa^Pr\, Isa^Pr\, Isa, Isa, Isa, Isa, Isa, Isa, Isa^Pr\, Xoa, Xoa, Isa, Xoa, Xoa, Isa^Pr/, Isa, Xoa, Xv
Xv, Xoa, Xoa, Isa, Isa, Isa, Isa, Isa^Pr\, Isa^Pr\, Isa, Isa, Isa, Isa, Isa, Xoa, Xoa, Isa, Isa, Isa, Isa, Xoa, Xoa, Xoa, Isa, Isa, Isa, Isa, Xoa, Xoa, Isa, Xoa, Isa^Pr/, Urb, Xoa, Xoa, Xoa, Xv
Xv, Xoa, Xoa, Xoa, Xuc, Isa, Isa, Isa, Isa, Xoa, Xoa, Isa, Xoa, Xoa, Isa, Isa^Pr\, Isa^Pr\, Isa, Isa, Isa, Isa, Xoa, Isa, Isa^Pr\, Xoa, Isa, Isa, Isa, Isa^Pr/, Xoa, Xoa, Urb, Urb, Urb, Urb, Xoa, Xv
Xv, Xoa, Iwo, Iwo, Iwo, Xoa, Xoa, Isa, Isa, Isa, Isa^Pr/, Xoa, Isa, Isa, Isa, Isa, Xoa, Xoa, Xoa, Isa, Isa, Xoa, Xoa, Xoa, Isa, Xoa, Xoa, Isa^Pr/, Urb, Urb, Urb, Urb, Urb, Urb, Urb, Xoa, Xv
Xv, Xoa, Xoa, Iwo, Iwo, Iwo, Xoa, Xoa, Xoa, Isa^Pr/, Isa, Isa, Isa, Isa, Xoa, Xoa, Isa, Isa, Xoa, Isa, Isa, Xoa, Isa, Isa, Isa^Pr/, Xoa, Urb, Xoa, Urb, Urb, Urb, Urb, Urb, Urb, Xoa, Xoa, Xv
Xv, Xoa, Xoa, Xoa, Xoa, Xoa, Isa, Isa, Isa, Xoa, Xoa, Isa, Isa^Pr/, Isa^Pr/, Urb, Isa^Pr\, Xoa, Xoa, Isa, Isa, Isa, Xoa, Xoa, Xoa, Urb, Urb, Urb, Urb, Urb, Urb, Urb, Urb, Xoa, Xoa, Xv, Xv, Xv
Xv, Xv, Xv, Xoa, Isa, Isa, Isa, Isa, Xoa, Xoa, Urb, Xoa, Xoa, Urb, Urb, Urb, Xoa, Isa, Ur, Ur, Ur, Isa, Xoa, Urb, Urb, Urb, Urb, Urb, Urb, Urb, Urb, Urb, Xoa, Xv, Xv, Xv, Xv
Xv, Xv, Xv, Xoa, Xoa, Isa, Xoa, Isa^Pr/, Urb, Urb, Urb, Urb, Urb, Xoa, Urb, Urb, Xoa, Isa, Ur, Ur, Ur, Isa, Xoa, Xoa, Isa^Pr\, Urb, Urb, Urb, Urb, Urb, Xoa, Xoa, Xv, Xv, Xv, Xv, Xv
Xv, Xv, Xv, Xv, Xv, Xoa, Xv, Xoa, Xoa, Urb, Xoa, Urb, Urb, Urb, Urb, Urb, Xoa, Isa, Isa, Ur, Isa, Isa, Xoa, Isa, Isa, Xoa, Xoa, Urb, Xoa, Isa^Pr/, Isa, Xoa, Xv, Xv, Xv, Xv, Xv
Xv, Xv, Xv, Xv, Xv, Xv, Xv, Xv, Xoa, Urb, Urb, Xoa, Urb, Xoa, Xoa, Urb, Urb, Xoa, Xoa, Xoa, Xoa, Xoa, Xoa, Isa, Isa, Isa, Xoa, Xoa, Xoa, Isa, Xoa, Xoa, Xv, Xv, Xv, Xv, Xv
Xv, Xv, Xv, Xv, Xv, Xv, Xv, Xv, Xv, Xoa, Xoa, Xoa, Xoa, Urb, Xoa, Urb, Xoa, Xoa, Xv, Xv, Xv, Xoa, Xoa, Xoa, Xoa, Xoa, Xv, Xv, Xv, Xoa, Xv, Xv, Xv, Xv, Xv, Xv, Xv
Xv, Xv, Xv, Xv, Xv, Xv, Xv, Xv, Xv, Xv, Xv, Xv, Xv, Xoa, Gg, Xoa, Xv, Xv, Xv, Xv, Xv, Xv, Xv, Xv, Xv, Xv, Xv, Xv, Xv, Xv, Xv, Xv, Xv, Xv, Xv, Xv, Xv
