Xv, Xv, Xv, Xv, Xv, Xv, Xv, Xv, Xv, Xv, Xv, Xv, Xv, Xv, Xv, Xv, Xv, Xv, Xv, Xv, Xv, Xv, Xv, Xv, Xv, Xv, Xv, Xv, Xv, Xv, Xv, Xv, Xv, Xv, Xv, Xv, Xv
Xv, Xv, Xv, Xv, Xv, Xv, Xv, Xv, Xv, Xv, Xv, Xv, Xv, Xv, Xoa, Xv, Xv, Xv, Xv, Xv, Xv, Xv, Xoa, Xoa, Xoa, Xv, Xv, Xv, Xoa, Xv, Xv, Xv, Xv, Xv, Xv, Xv, Xv
Xv, Xv, Xv, Xv, Xv, Xv, Xv, Xv, Xoa, Xv, Xv, Xv, Xoa, Xoa, Ias, Xoa, Xoa, Xv, Xoa, Xoa, Xoa, Xoa, Ias, Ias, Ias, Xoa, Xoa, Xoa, Ias, Xoa, Xoa, Xv, Xv, Xv, Xv, Xv, Xv
Xv, Xv, Xv, Xv, Xoa, Xoa, Xoa, Xoa, Ias, Xoa, Xoa, Xoa, Ias, Ias, Ias, Ias, Ias, Xoa, Ias, Ias, Ias, Ias, Ias, Ias, Ias, Ias, Ias, Ias, Ias, Ias, Ias, Xoa, Xoa, Xv, Xv, Xv, Xv
Xv, Xv, Xoa, Xoa, Ias, Ias, Ias, Ias, Ias, Ias, Ias, Ias, Ur, Ur, Ur, Ias, Ias, Ias, Ias, Ias, Ias, Ias, Ias, Ias, Ias, Ias, Ias, Ias, Ias, Ias, Ias, Ias, Ias, Xoa, Xv, Xv, Xv
Xv, Xv, Xoa, Ias, Ias, Ias, Ias, Ias, Ias, Ias, Ias, Ias, Ur, 1 Ur, Ur, Ias, Ias, Ias, Ias, Ias, Ias, Ias, Ias, Ias, Ias, Ias, Ias, Ias, Ias, Ias, Ias, Ias, Ias, Xoa, Xoa, Xv, Xv
Xv, Xoa, Ias, Ias, Ur, Ias, Ias, Ias, Ias, Ias, Ias, Ias, Ias, Ur, Ias, Ias, Ias, Ias, Ias, Ias, Ias, Ias, Ias, Ias, Ias, Ias, Ias, Ias, Ias, Ias, Ias, Ias, Ias, Ias, Xoa, Xv, Xv
Xv, Xoa, Ias, Ur, Ur, Ur, Ias, Ias, Ias, Ias, Ias, Ias, Ias, Ias, Ias, Ias, Ias, Ias, Ias, Ias, Ias, Ias, Ias, Ias, Ias, Ias, Ias, Ias, Ias, Ias, Ias, Ias, Ias, Ias, Ias, Xoa, Xv
Xv, Xoa, Ias, Ur, Ur, Ur, Ias, Ias, Ias, Ias, Ias, Ias, Ias, Ias, Ias, Ias, Ias, Ias, Ias, Ias, Ias, Ias, Ias, Ias, Ias, Ias, Ias, Ias, Ias, Ias, Ias, Ias, Ias, Ias, Ias, Xoa, Xv
Xv, Xoa, Ias, Ias, Ias, Ias, Ias, Ias, Ias, Ias, Ias, Ias, Ias, Ias, Ias, Ias, Ias, Ias, Ias, Ias, Ias, Ias, Ias, Ias, Ias, Ias, Ias, Ias, Ias, Ias, Ias, Ias, Ias, Ias, Ias, Xoa, Xv
Xv, Xoa, Ias, Ias, Ias, Ias, Ias, Ias, Ias, Ias, Ias, Ias, Ias, Ias, Ias, Ias, Ias, Ias, Ias, Ias, Ias, Ias, Ias, Ias, Ias, Ias, Ias, Ias, Ias, Ias, Ias, Ias, Ias, Ias, Ias, Xoa, Xv
Xv, Xoa, Ias, Ias, Ias, Ias, Ias, Ias, Ias, Ias, Ias, Ias, Ias, Ias, Ias, Ias, Ias, Ias, Ias, Ias, Ias, Ias, Ias, Ias, Ias, Ias, Ias, Ias, Ias, Ias, Ias, Ias, Ias, Ias, Ias, Xoa, Xv
Xv, Xoa, Ias, Ias, Ias, Ias, Ias, Ias, Ias, Ias, Ias, Ias, Ias, Ias, Ias, Ias, Ias, Ias, Ias, Ias, Ias, Ias, Ias, Ias, Ias, Ias, Ias, Ias, Ias, Ias, Ias, Ias, Ias, Ias, Xoa, Xoa, Xv
Xv, Xoa, Xoa, Ias, Ias, Ias, Ias, Ias, Ias, Ias, Ias, Ias, Ias, Ias, Ias, Ias, Ias, Ias, Ias, Ias, Ias, Ias, Ias, Ias, Ias, Ias, Ias, Ias, Ias, Ias, Ias, Ias, Xoa, Xoa, Xv, Xv, Xv
Xv, Xv, Xv, Xoa, Ias, Ias, Ias, Ias, Ias, Ias, Ias, Ias, Ias, Ias, Ias, Ias, Ias, Ias, Ias, Ias, Ias, Ias, Ias, Ias, Ias, Ias, Ias, Ias, Ias, Ias, Ias, Ias, Xoa, Xv, Xv, Xv, Xv
Xv, Xv, Xv, Xoa, Xoa, Ias, Xoa, Ias, Ias, Ias, Ias, Ias, Ias, Ias, Ias, Ias, Ias, Ias, Ias, Ias, Ias, Ias, Ias, Ias, Ias, Ias, Ias, Ias, Ias, Ias, Ias, Xoa, Xv, Xv, Xv, Xv, Xv
Xv, Xv, Xv, Xv, Xv, Xoa, Xv, Xoa, Xoa, Ias, Ias, Ias, Ias, Ias, Ias, Ias, Ias, Ias, Ias, Ias, Ias, Ias, Ias, Ias, Ias, Ias, Ias, Ias, Ias, Ias, Ias, Xoa, Xv, Xv, Xv, Xv, Xv
Xv, Xv, Xv, Xv, Xv, Xv, Xv, Xv, Xoa, Ias, Ias, Ias, Ias, Ias, Ias, Ias, Ias, Ias, Xoa, Xoa, Xoa, Ias, Ias, Ias, Ias, Ias, Xoa, Xoa, Xoa, Ias, Xoa, Xoa, Xv, Xv, Xv, Xv, Xv
Xv, Xv, Xv, Xv, Xv, Xv, Xv, Xv, Xv, Xoa, Xoa, Xoa, Xoa, Ias, Xoa, Ias, Xoa, Xoa, Xv, Xv, Xv, Xoa, Xoa, Xoa, Xoa, Xoa, Xv, Xv, Xv, Xoa, Xv, Xv, Xv, Xv, Xv, Xv, Xv
Xv, Xv, Xv, Xv, Xv, Xv, Xv, Xv, Xv, Xv, Xv, Xv, Xv, Xoa, Gg, Xoa, Xv, Xv, Xv, Xv, Xv, Xv, Xv, Xv, Xv, Xv, Xv, Xv, Xv, Xv, Xv, Xv, Xv, Xv, Xv, Xv, Xv
