Xv, Xv, Xv, Xv, Xv, Xv, Xv, Xv, Xv, Xv, Xv, Xv, Xv, Xv, Xv, Xv, Xv, Xv, Xv, Xv, Xv, Xv, Xv, Xv, Xv, Xv, Xv, Xv, Xv, Xv, Xv, Xv, Xv, Xv, Xv, Xv, Xv
Xv, Xv, Xv, Xv, Xv, Xv, Xv, Xv, Xv, Xv, Xv, Xv, Xv, Xv, Xoa, Xv, Xv, Xv, Xv, Xv, Xv, Xv, Xoa, Xoa, Xoa, Xv, Xv, Xv, Xoa, Xv, Xv, Xv, Xv, Xv, Xv, Xv, Xv
Xv, Xv, Xv, Xv, Xv, Xv, Xv, Xv, Xoa, Xv, Xv, Xv, Xoa, Xoa, Ias, Xoa, Xoa, Xv, Xoa, Xoa, Xoa, Xoa, Ias, Ias, Ias, Xoa, Xoa, Xoa, Ias, Xoa, Xoa, Xv, Xv, Xv, Xv, Xv, Xv
Xv, Xv, Xv, Xv, Xoa, Xoa, Xoa, Xoa, Uu, Xoa, Xoa, Xoa, Ias, Ias, Ias, Ias, Ias, Xoa, Cud, Xoa, Uu, Ias, Ias, Uu, Ias, Ias, Xoa, Ias, Ias, Ias, Ias, Xoa, Xoa, Xv, Xv, Xv, Xv
Xv, Xv, Xoa, Xoa, Ias, Ias, Ias, Ias, Xoa, Ias, Xoa, Xoa, Xoa, Ias, Ias, Uu, Cud, Cud, Cud, Cud, Cud, Ias, Uu, Ias, Xoa, Xoa, Xoa, Xoa, Cud, Cud, Cud, Uu, Uu, Xoa, Xv, Xv, Xv
Xv, Xv, Xoa, Ias, Ias, Ias, Cud, Cud, Cud, Xoa, Ias, Ias, Ias, Xoa, Cud, Cud, Cud, Cud, Cud, Cud, Cud, Cud, Cud, Xoa, Ias, Uu, Ias, Xoa, Cud, Ias, Cud, Ias, Ias, Xoa, Xoa, Xv, Xv
Xv, Xoa, Ias, Uu, Uu, Xoa, Cud, Ias, Cud, Xoa, Ias, Ias, Uu, Ias, Cud, Cud, Cud, Cud, Cud, Cud, Cud, Cud, Cud, Ias, Uu, Ias, Ias, Xoa, Xoa, Cud, Ias, Uu, Uu, Uu, Xoa, Xv, Xv
Xv, Xoa, Uu, Ias, Xoa, Xoa, Ias, Cud, Ias, Uu, Uu, Ias, Ias, Ias, Cud, Cud, Cud, Cud, 2 Kud, Cud, Cud, Cud, Cud, Ias, Ias, Ias, Uu, Uu, Ias, Ias, Ias, Uu, Ias, Uu, Uu, Xoa, Xv
Xv, Xoa, Ias, Uu, Xoa, Uu, Uu, Uu, Ias, Ias, Xoa, Xoa, Uu, Ias, Cud, Cud, Cud, Cud, Cud, Cud, Cud, Cud, Cud, Ias, Ias, Xoa, Xoa, Uu, Uu, Ias, Cud, Cud, Cud, Ias, Ias, Xoa, Xv
Xv, Xoa, Ias, Ias, Cud, Cud, Cud, Ias, Ias, Ias, Xoa, Xoa, Ias, Ias, Cud, Cud, Cud, Cud, Cud, Cud, Cud, Cud, Cud, Uu, Ias, Xoa, Xoa, Ias, Uu, Ias, Cud, Ias, Cud, Uu, Ias, Xoa, Xv
Xv, Xoa, Ias, Ias, Cud, Ias, Cud, Ias, Ias, Ias, Uu, Xoa, Ias, Ias, Ias, Cud, Cud, Cud, Cud, Cud, Cud, Cud, Ias, Ias, Ias, Xoa, Ias, Ias, Ias, Ias, Ias, Cud, Ias, Uu, Ias, Xoa, Xv
Xv, Xoa, Ias, Ias, Uu, Cud, Xoa, Uu, Xoa, Ias, Uu, Ias, Ias, Uu, Uu, Ias, Xoa, Cud, Cud, Cud, Uu, Ias, Ias, Ias, Ias, Ias, Ias, Ias, Xoa, Uu, Xoa, Xoa, Uu, Uu, Ias, Xoa, Xv
Xv, Xoa, Uu, Ias, Uu, Ias, Ias, Xoa, Cud, Xoa, Xoa, Ias, Ias, Ias, Ias, Xoa, Ias, Xoa, Xoa, Xoa, Xoa, Ias, Xoa, Uu, Ias, Ias, Xoa, Xoa, Cud, Xoa, Uu, Ias, Ias, Uu, Xoa, Xoa, Xv
Xv, Xoa, Xoa, Ias, Uu, Uu, Ias, Cud, Ias, Cud, Xoa, Uu, Uu, Ias, Ias, Ias, Ias, Ias, Ias, Uu, Ias, Xoa, Ias, Ias, Ias, Uu, Xoa, Cud, Ias, Cud, Ias, Ias, Xoa, Xoa, Xv, Xv, Xv
Xv, Xv, Xv, Xoa, Ias, Uu, Ias, Cud, Cud, Cud, Ias, Xoa, Xoa, Xoa, Ias, Uu, Uu, Uu, Ur, Ur, Ur, Ias, Ias, Uu, Ias, Ias, Xoa, Cud, Cud, Cud, Uu, Ias, Xoa, Xv, Xv, Xv, Xv
Xv, Xv, Xv, Xoa, Xoa, Ias, Xoa, Ias, Uu, Ias, Ias, Ias, Xoa, Uu, Ias, Ias, Uu, Ias, Ur, 1 Ur, Ur, Ias, Ias, Ias, Ias, Ias, Xoa, Ias, Ias, Ias, Ias, Xoa, Xv, Xv, Xv, Xv, Xv
Xv, Xv, Xv, Xv, Xv, Xoa, Xv, Xoa, Xoa, Ias, Ias, Xoa, Cud, Uu, Ias, Ias, Uu, Ias, Uu, Ur, Ias, Uu, Ias, Uu, Cud, Cud, Xoa, Xoa, Ias, Uu, Ias, Xoa, Xv, Xv, Xv, Xv, Xv
Xv, Xv, Xv, Xv, Xv, Xv, Xv, Xv, Xoa, Ias, Uu, Xoa, Cud, Cud, Ias, Uu, Ias, Ias, Xoa, Xoa, Xoa, Uu, Ias, Ias, Cud, Cud, Xoa, Xoa, Xoa, Ias, Xoa, Xoa, Xv, Xv, Xv, Xv, Xv
Xv, Xv, Xv, Xv, Xv, Xv, Xv, Xv, Xv, Xoa, Xoa, Xoa, Xoa, Cud, Xoa, Uu, Xoa, Xoa, Xv, Xv, Xv, Xoa, Xoa, Xoa, Xoa, Xoa, Xv, Xv, Xv, Xoa, Xv, Xv, Xv, Xv, Xv, Xv, Xv
Xv, Xv, Xv, Xv, Xv, Xv, Xv, Xv, Xv, Xv, Xv, Xv, Xv, Xoa, Gg, Xoa, Xv, Xv, Xv, Xv, Xv, Xv, Xv, Xv, Xv, Xv, Xv, Xv, Xv, Xv, Xv, Xv, Xv, Xv, Xv, Xv, Xv
