Xv, Xv, Xv, Xv, Xv, Xv, Xv, Xv, Xv, Xv, Xv, Xv, Xv, Xv, Xv, Xv, Xv, Xv, Xv, Xv, Xv, Xv, Xv, Xv, Xv, Xv, Xv, Xv, Xv, Xv, Xv, Xv, Xv, Xv, Xv, Xv, Xv
Xv, Xv, Xv, Xv, Xv, Xv, Xv, Xv, Xv, Xv, Xv, Xv, Xv, Xv, Xoa, Xv, Xv, Xv, Xv, Xv, Xv, Xv, Xoa, Xoa, Xoa, Xv, Xv, Xv, Xoa, Xv, Xv, Xv, Xv, Xv, Xv, Xv, Xv
Xv, Xv, Xv, Xv, Xv, Xv, Xv, Xv, Xoa, Xv, Xv, Xv, Xoa, Xoa, Isa, Xoa, Xoa, Xv, Xoa, Xoa, Xoa, Xoa, Isa, Isa, Isa, Xoa, Xoa, Xoa, Isa, Xoa, Xoa, Xv, Xv, Xv, Xv, Xv, Xv
Xv, Xv, Xv, Xv, Xoa, Xoa, Xoa, Xoa, Uu, Xoa, Xoa, Xoa, Isa, Isa, Isa, Isa, Isa, Xoa, Cud, Xoa, Uu, Isa, Isa, Uu, Isa, Isa, Xoa, Isa, Isa, Isa, Isa, Xoa, Xoa, Xv, Xv, Xv, Xv
Xv, Xv, Xoa, Xoa, Isa, Isa, Isa, Isa, Xoa, Isa, Isa, Xoa, Xoa, Isa, Isa, Uu, Cud, Cud, Cud, Cud, Cud, Isa, Uu, Isa, Xoa, Xoa, Isa, Xoa, Cud, Cud, Cud, Uu, Uu, Xoa, Xv, Xv, Xv
Xv, Xv, Xoa, Isa, Isa, Isa, Cud, Cud, Cud, Isa, Isa, Isa, Isa, Xoa, Cud, Cud, Cud, Cud, Cud, Cud, Cud, Cud, Cud, Xoa, Isa, Uu, Isa, Isa, Cud, Isa, Cud, Isa, Isa, Xoa, Xoa, Xv, Xv
Xv, Xoa, Isa, Uu, Uu, Xoa, Cud, Isa, Cud, Isa, Isa, Isa, Uu, Isa, Cud, Cud, Cud, Cud, Cud, Cud, Cud, Cud, Cud, Isa, Uu, Isa, Isa, Isa, Isa, Cud, Xoa, Uu, Uu, Uu, Xoa, Xv, Xv
Xv, Xoa, Uu, Isa, Xoa, Xoa, Isa, Cud, Isa, Uu, Uu, Isa, Isa, Isa, Cud, Cud, Cud, Cud, 2 Kud, Cud, Cud, Cud, Cud, Isa, Isa, Isa, Uu, Uu, Isa, Isa, Isa, Xoa, Isa, Uu, Uu, Xoa, Xv
Xv, Xoa, Isa, Uu, Xoa, Uu, Uu, Uu, Isa, Isa, Xoa, Xoa, Uu, Isa, Cud, Cud, Cud, Cud, Cud, Cud, Cud, Cud, Cud, Isa, Isa, Xoa, Xoa, Uu, Uu, Isa, Cud, Cud, Cud, Isa, Isa, Xoa, Xv
Xv, Xoa, Isa, Isa, Cud, Cud, Cud, Isa, Isa, Isa, Xoa, Xoa, Isa, Isa, Cud, Cud, Cud, Cud, Cud, Cud, Cud, Cud, Cud, Uu, Isa, Xoa, Xoa, Isa, Uu, Isa, Cud, Isa, Cud, Uu, Isa, Xoa, Xv
Xv, Xoa, Isa, Isa, Cud, Isa, Cud, Isa, Isa, Isa, Uu, Xoa, Isa, Isa, Isa, Cud, Cud, Cud, Cud, Cud, Cud, Cud, Isa, Isa, Isa, Xoa, Isa, Isa, Isa, Isa, Isa, Cud, Isa, Uu, Isa, Xoa, Xv
Xv, Xoa, Isa, Isa, Uu, Cud, Isa, Uu, Isa, Isa, Uu, Isa, Isa, Uu, Uu, Isa, Xoa, Cud, Cud, Cud, Uu, Isa, Isa, Isa, Isa, Isa, Isa, Isa, Isa, Uu, Isa, Isa, Uu, Uu, Isa, Xoa, Xv
Xv, Xoa, Uu, Isa, Uu, Isa, Isa, Isa, Cud, Xoa, Xoa, Isa, Isa, Isa, Isa, Xoa, Isa, Xoa, Xoa, Xoa, Xoa, Isa, Xoa, Uu, Isa, Isa, Isa, Isa, Cud, Isa, Uu, Isa, Isa, Uu, Xoa, Xoa, Xv
Xv, Xoa, Xoa, Isa, Uu, Uu, Isa, Cud, Isa, Cud, Isa, Uu, Uu, Isa, Isa, Isa, Isa, Isa, Isa, Uu, Isa, Xoa, Isa, Isa, Isa, Uu, Xoa, Cud, Isa, Cud, Isa, Isa, Xoa, Xoa, Xv, Xv, Xv
Xv, Xv, Xv, Xoa, Isa, Uu, Isa, Cud, Cud, Cud, Isa, Isa, Xoa, Xoa, Isa, Uu, Uu, Uu, Ur, Ur, Ur, Isa, Isa, Uu, Isa, Isa, Xoa, Cud, Cud, Cud, Uu, Isa, Xoa, Xv, Xv, Xv, Xv
Xv, Xv, Xv, Xoa, Xoa, Isa, Xoa, Isa, Uu, Isa, Isa, Isa, Xoa, Uu, Isa, Isa, Uu, Isa, Ur, 1 Ur, Ur, Isa, Isa, Isa, Isa, Isa, Xoa, Isa, Isa, Isa, Isa, Xoa, Xv, Xv, Xv, Xv, Xv
Xv, Xv, Xv, Xv, Xv, Xoa, Xv, Xoa, Xoa, Isa, Isa, Xoa, Cud, Uu, Isa, Isa, Uu, Isa, Uu, Ur, Isa, Uu, Isa, Uu, Cud, Cud, Xoa, Xoa, Isa, Uu, Isa, Xoa, Xv, Xv, Xv, Xv, Xv
Xv, Xv, Xv, Xv, Xv, Xv, Xv, Xv, Xoa, Isa, Uu, Xoa, Cud, Cud, Isa, Uu, Isa, Isa, Xoa, Xoa, Xoa, Uu, Isa, Isa, Cud, Cud, Xoa, Xoa, Xoa, Isa, Xoa, Xoa, Xv, Xv, Xv, Xv, Xv
Xv, Xv, Xv, Xv, Xv, Xv, Xv, Xv, Xv, Xoa, Xoa, Xoa, Xoa, Cud, Xoa, Uu, Xoa, Xoa, Xv, Xv, Xv, Xoa, Xoa, Xoa, Xoa, Xoa, Xv, Xv, Xv, Xoa, Xv, Xv, Xv, Xv, Xv, Xv, Xv
Xv, Xv, Xv, Xv, Xv, Xv, Xv, Xv, Xv, Xv, Xv, Xv, Xv, Xoa, Gg, Xoa, Xv, Xv, Xv, Xv, Xv, Xv, Xv, Xv, Xv, Xv, Xv, Xv, Xv, Xv, Xv, Xv, Xv, Xv, Xv, Xv, Xv
