Gll^Fp, Gs^Fms, Gs^Fds, Gll^Fp, Gll^Fp, Gll^Fmw, Gll^Fp, Gll^Fp, Gll^Fp, Gs^Fms, Gs^Fms, Gll^Fp, Gll^Fp, Gll^Fp, Gs^Fms, Gll^Fp, Gll^Fp, Gll^Fp, Gll^Fp, Gll^Fp, Gll^Fp, Gs^Fms, Gll^Fp, Gs^Fms
Gll^Fp, Gll^Fp, Gll^Fp, Gll^Fp, Gs^Fds, Gll^Fp, Gll^Fp, Gll^Fp, Gs^Fms, Gll^Fp, Gll^Fp, Gll^Fp, Gs^Fds, Gs^Fds, Gs^Fds, Gll^Fp, Gll^Fp, Gs^Fds, Gll^Fp, Gll^Fp, Rb, Gll^Fp, Gll^Fp, Gll^Fp
Gs^Fds, Gll^Fmw, Gll^Fmf, Gs^Fms, Gll^Fdf, Gll^Fmf, Gll^Fp, Gs^Fds, Gll^Fp, Gs^Fms, Gll^Fdf, Gll^Fp, Gll^Fmw, Gll^Fp, Gll^Fp, Gs^Fms, Gll^Fp, Gll^Fmw, Gll^Fp, Gll^Fp, 1 Rb, Rb, Gll^Fp, Gll^Fp
Gs^Fds, Gs^Fms, Gll^Fdw, 2 Gll^Fmw, Gll^Fmf, Gll^Fp, Gs^Fds, Gll^Fp, Gll^Fmf, Gll^Fp, Gll^Fmf, Gll^Fp, Gll^Fp, Gs^Fds, Gll^Fp, Gll^Fp, Gs^Fms, Gll^Fmf, Gs^Fds, Rb, Rb, Gll^Fp, Gll^Fp, Gll^Fp
Gll^Fp, Gll^Fp, Gll^Fp, Gll^Fp, Gll^Fp, Gs^Fms, Gll^Fp, Gll^Fp, Gll^Fp, Gll^Fdf, Gs^Fms, Gll^Fmw, Gll^Fp, Gll^Fp, Gll^Fmf, Gll^Fmf, Rb, Gll^Fp, Gll^Fp, Rb, Gll^Fp, Gll^Fmf, Gs^Fms, Gll^Fmw
Gll^Fp, Gs^Fds, Gll^Fp, Gll^Fp, Gll^Fp, Gll^Fp, Gll^Fp, Gll^Fp, Gll^Fp, Gll^Fp, Gll^Fp, Gll^Fp, Gs^Fms, Gll^Fp, Gll^Fp, Rb, Gll^Fp, Gll^Fp, Gll^Fp, Gs^Fms, Gll^Fp, Gll^Fp, Gll^Fp, Gll^Fp
Gll^Fp, Gll^Fmw, Gll^Fp, Gll^Fmw, Gll^Fmf, Gll^Fp, Gll^Fmf, Gll^Fp, Gll^Fp, Gs^Fms, Gll^Fp, Gll^Fp, Gs^Fms, Gll^Fp, Rb, Rb, Gs^Fds, Gs^Fds, Gll^Fp, Gll^Fp, Gll^Fp, Gll^Fmw, Gll^Fp, Gs^Fds
Gll^Fmw, Gll^Fp, Gll^Fp, Gs^Fms, Gll^Fp, Gll^Fp, Gll^Fdf, Gs^Fms, Gll^Fp, Gs^Fms, Gll^Fmf, Gll^Fp, Gs^Fms, Gll^Fmf, Rb, Gll^Fp, Gll^Fp, Gll^Fp, Gll^Fmf, Gll^Fp, Gll^Fp, Gs^Fms, Gll^Fdf, Gll^Fdw
Gll^Fp, Gll^Fmf, Gll^Fmw, Gs^Fms, Gll^Fp, Gll^Fp, Gs^Fms, Gll^Fp, Gll^Fp, Gll^Fp, Gll^Fp, Gll^Fp, Gs^Fds, Gll^Fp, Gll^Fp, Gll^Fmf, Gs^Fds, Gll^Fp, Gll^Fp, Gll^Fmf, Gs^Fms, Gll^Fp, Gll^Fp, Gll^Fp
Gll^Fp, Gll^Fp, Gll^Fdf, Gll^Fp, Gll^Fdw, Gll^Fp, Gll^Fp, Gll^Fp, Gll^Fdf, Gll^Fp, Gs^Fds, Gll^Fp, Gs^Fms, Gll^Fdw, Gll^Fp, Gll^Fp, Gll^Fp, Gll^Fmf, Gll^Fp, Gll^Fp, Gll^Fp, Gll^Fp, Gll^Fp, Gll^Fdf
Gll^Fmw, Gs^Fds, Gll^Fp, Gs^Fds, Gll^Fp, Gll^Fp, Gs^Fms, Gs^Fds, Gll^Fp, Gll^Fp, Rb, Gll^Fdw, Gll^Fmf, Gll^Fp, Gs^Fds, Gll^Fp, Gll^Fp, Gll^Fdf, Gll^Fp, Gll^Fp, Gll^Fp, Gs^Fms, Gll^Fp, Gll^Fmw
Gs^Fds, Gll^Fp, Gll^Fp, Gll^Fp, Gs^Fms, Gll^Fp, Gll^Fp, Gll^Fp, Rb, Rb, Rb, Rb, Gll^Fdw, Gll^Fp, Gll^Fp, Gs^Fms, Gll^Fp, Gll^Fp, Gll^Fp, Gs^Fms, Gll^Fp, Gll^Fdf, Gs^Fms, Gll^Fp
Gll^Fp, Gll^Fp, Gll^Fmw, Gll^Fp, Gll^Fp, Gll^Fp, Gll^Fp, Gs^Fds, Rb, Gs^Fms, Gll^Fp, Gll^Fmf, Gll^Fp, Gs^Fms, Gs^Fds, Gll^Fp, Gs^Fms, Gll^Fp, Gs^Fms, Gll^Fp, Gll^Fp, Gll^Fp, Gll^Fp, Gll^Fp
Gll^Fp, Gll^Fdf, Gll^Fmw, Gll^Fp, Gll^Fp, Gll^Fp, Gll^Fp, Rb, Gs^Fms, Gs^Fms, Gll^Fp, Gll^Fdf, Gll^Fp, Gll^Fmf, Gll^Fp, Gll^Fp, Gll^Fp, Gll^Fp, Gll^Fmw, Gll^Fp, Gll^Fp, Gll^Fp, Gll^Fp, Gs^Fms
Gll^Fp, Gll^Fp, Gs^Fms, Gll^Fp, Gll^Fp, Gll^Fp, Gs^Fms, Gll^Fp, Gll^Fp, Gll^Fp, Gll^Fp, Gll^Fp, Gs^Fms, Gs^Fms, Gll^Fmw, Gll^Fp, Gll^Fdw, Gs^Fms, Gll^Fp, Gll^Fp, Gll^Fp, Gll^Fmf, Gll^Fp, Gll^Fp
Gll^Fp, Gll^Fp, Gll^Fp, Gll^Fp, Gll^Fp, Gs^Fms, Rb, Gll^Fp, Gll^Fp, Gll^Fp, Gs^Fds, Gll^Fp, Gll^Fp, Gll^Fdf, Gll^Fp, Gll^Fdf, Gll^Fp, Gs^Fms, Gll^Fp, Gll^Fmw, Gll^Fp, Gs^Fms, Gll^Fp, Gll^Fp
Gll^Fp, Gll^Fp, Gll^Fp, Gs^Fds, Gll^Fp, Rb, Gll^Fp, Gll^Fmf, Gll^Fp, Gs^Fms, Gll^Fp, Gll^Fmw, Gll^Fp, Gll^Fp, Gll^Fmf, Gs^Fds, Gll^Fmw, Gll^Fp, Gs^Fms, Gll^Fp, Gll^Fmw, Gll^Fdf, Gll^Fp, Gll^Fdf
Gll^Fp, Gs^Fms, Gs^Fds, Gll^Fp, Rb, Gll^Fp, Gll^Fmf, Gs^Fds, Gll^Fp, Gll^Fp, Gs^Fms, Gll^Fp, Gs^Fms, Gll^Fmf, Gll^Fp, Gll^Fmf, Gll^Fp, Gs^Fms, Gs^Fms, Gll^Fp, Gll^Fp, Gll^Fp, Gll^Fp, Gll^Fp
Gll^Fp, Gs^Fms, Gll^Fmw, Rb, Gll^Fp, Gll^Fp, Gll^Fp, Gs^Fds, Gll^Fmw, Gll^Fp, Gll^Fp, Gll^Fmw, Gll^Fp, Gll^Fmf, Gll^Fp, Gll^Fp, Gll^Fdf, Gll^Fp, Gll^Fp, Gs^Fds, Gll^Fp, Gll^Fp, Gs^Fms, Gll^Fp
Gs^Fds, Gs^Fms, Rb, Rb, Gll^Fp, Gll^Fdw, Gll^Fp, Gs^Fds, Gll^Fp, Gll^Fmf, Gll^Fp, Gll^Fp, Gll^Fp, Gll^Fp, Gll^Fmf, Gs^Fds, Gs^Fms, Gs^Fms, Gll^Fmw, Gll^Fp, Gll^Fp, Gs^Fms, Gll^Fp, Gll^Fmf
Rb, Rb, Gll^Fp, Gll^Fp, Gll^Fp, Gll^Fp, Gll^Fp, Gll^Fp, Gll^Fp, Gll^Fmw, Gs^Fds, Gs^Fms, Gll^Fmf, Gll^Fmf, Gll^Fp, Gll^Fdf, Gll^Fmf, Gll^Fp, Gs^Fms, Gll^Fmw, Gll^Fp, Gs^Fms, Gs^Fms, Gll^Fp
Rb, Rb, Gll^Fp, Gll^Fp, Gll^Fp, Gll^Fp, Gll^Fmf, Gll^Fmf, Gll^Fp, Gll^Fmf, Gll^Fmw, Gll^Fp, Gll^Fp, Gs^Fms, Gll^Fp, Gll^Fdw, Gs^Fms, Gll^Fp, Gll^Fp, Gll^Fp, Gs^Fms, Gll^Fp, Gll^Fmf, Gs^Fds
Gll^Fdf, Gll^Fmf, Gll^Fp, Gll^Fp, Gll^Fp, Gs^Fms, Gll^Fmf, Gs^Fds, Gll^Fp, Gs^Fms, Gll^Fp, Gll^Fmw, Gs^Fms, Gs^Fms, Gll^Fmw, Gll^Fp, Gll^Fmf, Gll^Fp, Gll^Fdf, Gll^Fp, Gll^Fp, Gs^Fms, Gll^Fp, Gll^Fmf
