Xu, Xu, Xu, Xu, Xu, Xu, Xos, Xu, Xos, Xu, Xu, Xu, Wog, Xu, Xu, Xu, Xu, Xu, Xu, Xu, Xu, Xu, Xu, Xu, Xu
Xu, Xu, Xu, Xu, Xos, Xos, Rr, Xos^Efs, Re, Xos, Xu, Xu, Wog, Xu, Xu, Xu, Xu, Xu, Xu, Xu, Xu, Xu, Xu, Xu, Xu
Xu, Xu, Xu, Xu, Xu, Xos, Rr, Re, Re, Xu, Xu, Xu, Wog, Xu, Xu, Xu, Xu, Xu, Xu, Xu, Xu, Xu, Xu, Xu, Xu
Xu, Xu, Xu, Xu, Xu, Xos, Xos, Re, Xos, Rr, Xu, Xu, Xu, Wog, Wog, Xu, Xu, Xu, Xu, Xu, Xu, Xu, Xu, Xu, Xu
Xu, Xu, Xu, Xu, Xu, Xu, Xu, Xos, Xu, Rr^Pr|, Xu, Xu, Xu, Xu, Wog^Xo, Xu, Xu, Xu, Qxu, Xu, Qxu, Xu, Xu, Xu, Xu
Ur^Br\, Uu, Uu, Xu, Xu, Xu, Xu, Xu, Cud, Cud, Cud, Xu, Xu, Xu, Wog, Xu, Xu, Qxu, Qxu, Qxu, Qxu, Xu, Xu, Uu, Uu
Uu, Ur^Br\, Cud, Cud, Ur^Br\, Uh^Ebn, Uh^Tf, Uh^Tf, Uu, Uu, Uh, Xu, Xu, Wwg, Wwg, Xu, Cud, Qxu, Uh, Uh, Uh, Cud, Ur, Rr^Pr\o, Rr^Pr\o
Xu, Cud, Uh^Ii, Uu, Uu^Ii, Ur^Br\, Uu, Uu, Cud, Uu, Uu, Tb^Tf, Uu^Tf, Tb^Tf, Wwf^Es, Wwf, Tb^Tf, Uh^Tf, Ce, Ce^Es, Ce^Ecf, Ur, Cud, Rr, Xu
Xu, Xu, Uh^Tf, Uh^Ii, Uu, Ur^Br|, Ur^Br\, Cud, 2 Kud, Cud, Ur, Uu^Tf, Ur, Uu^Es, Ur^Es, Wwf, Ur, Ur, Ce^Ii, 1 Ke, Ce, Ur, Xu, Xu, Xu
Xu, Xu, Xu, Uu^Tf, Uh, Uu^Ii, Uh, Cud, Cud, Cud, Uue, Ur, Ur^Es, Ur, Ur, Wwf^Es, Wwf, Re, Uu^Ii, Ce, Uu, Uu, Xu, Xu, Xu
Xu, Xu, Xu, Xos, Cud, Uh, Uue, Rb, Uue^Emf, Rb, Re^Em, Uue^Es, Uu^Ebn, Uh, Uh^Tf, Tb^Tf, Tb^Tf, Wwf^Ii, Wwg, Uu, Uu, Xu, Xu, Xu, Xu
Xu, Xu, Xos, Xos, Rr^Pw\o, Cud, Cud, Uue^Em, Uue^Emf, Rb^Emf, Qxu, Qxu, Qxu, Uh^Tf, Qxu, Tb^Tf, Xu, Cud, Xu, Wwg, Xu, Xu, Xu, Xu, Xu
Xu, Xu, Xu, Rr, Re, Xos, Xos, Re^Emf, Re^Ebn, Re^Emf, Qxu, Qxu, Qxu, Qxu, Xu, Xu, Xu, Xu, Xu, Wog^Xo, Xu, Xu, Xu, Xu, Xu
Xu, Xu, Re, Rr, Xos, Xos, Xos, Qxu, Qxu, Qxu, Qxu, Qxu, Xu, Qxu, Xu, Xu, Xu, Xu, Xu, Wog, Wog, Xu, Xu, Xu, Xu
Xu, Xu, Re, Re, Xos, Xu, Xu, Xos, Xu, Xu, Xu, Xu, Xu, Xu, Xu, Xu, Xu, Xu, Xu, Xu, Xu, Wog, Wog, Xu, Xu
Xu, Xu, Xos, Re, Xos, Xu, Xu, Xu, Xu, Xu, Xu, Xu, Xu, Xu, Xu, Xu, Xu, Xu, Xu, Xu, Xu, Xu, Xu, Wog, Wog
Xu, Xu, Xu, Xos, Xu, Xu, Xu, Xu, Xu, Xu, Xu, Xu, Xu, Xu, Xu, Xu, Xu, Xu, Xu, Xu, Xu, Xu, Xu, Xu, Xu
Xu, Xu, Xu, Xu, Xu, Xu, Xu, Xu, Xu, Xu, Xu, Xu, Xu, Xu, Xu, Xu, Xu, Xu, Xu, Xu, Xu, Xu, Xu, Xu, Xu
Xu, Xu, Xu, Xu, Xu, Xu, Xu, Xu, Xu, Xu, Xu, Xu, Xu, Xu, Xu, Xu, Xu, Xu, Xu, Xu, Xu, Xu, Xu, Xu, Xu
Xu, Xu, Xu, Xu, Xu, Xu, Xu, Xu, Xu, Xu, Xu, Xu, Xu, Xu, Xu, Xu, Xu, Xu, Xu, Xu, Xu, Xu, Xu, Xu, Xu
