Ias, Ias, Ias, Ias, Ias, Ias, Ias, Ias, Ias, Ias, Ias, Ias, Xoi, Ias, Ias, Ias, Ias, Ias, Ias, Ias, Ias, Ias, Ias, Ias, Ias, Ias
Ias, Ias, Ias, Ias, Ias, Ias, Ias, Ias, Ias, Ias, Xoi, Xoi, Xoi, Xoi, Xoi, Ias, Ias, Ias, Ias, Ias, Ias, Ias, Ias, Ias, Ias, Ias
Ias, Ias, Ias, Ias, Ias, Ias, Ias, Ias, Xoi, Xoi, Xoi, Xoi, Ur, Xoi, Xoi, Xoi, Xoi, Ias, Ias, Ias, Ias, Ias, Ias, Ias, Ias, Ias
Ias, Ias, Ias, Ias, Ias, Ias, Ias, Xoi, Xoi, Xoi, Ias, Ur, Ias, Ur, Ias, Xoi, Xoi, Xoi, Ias, Ias, Ias, Ias, Ias, Ias, Ias, Ias
Ias, Ias, Ias, Ias, Ias, Ias, Ias, Xoi, Xoi, Ias, Ias, Ur, Ur, Ur, Ias, Ias, Xoi, Xoi, Ias, Ias, Ias, Ias, Ias, Ias, Ias, Ias
Ias, Ias, Ias, Ias, Ias, Ias, Ias, Xoi, Xoi, Cfr, Ias, Ias, Ias, Ias, Ias, Cfr, Xoi, Xoi, Ias, Ias, Ias, Ias, Ias, Ias, Ias, Ias
Ias, Ias, Ias, Ias, Ias, Ias, Ias, Xoi, Xoi, Cfr, Ias, Ias, Cfr, Ias, Ias, Cfr, Xoi, Xoi, Ias, Ias, Ias, Ias, Ias, Ias, Ias, Ias
Ias, Ias, Ias, Ias, Ias, Ias, Ias, Xoi, Ias^Xo, Ias, Ias, Cfr, 1 Kfr, Cfr, Ias, Ias, Ias^Xo, Xoi, Ias, Ias, Ias, Ias, Ias, Ias, Ias, Ias
Ias, Ias, Ias, Ias, Ias, Ias, Ias, Ias^Xo, Ias^Xo, Ias, Ias, Cfr, Cfr, Cfr, Ias, Ias, Ias^Xo, Ias^Xo, Ias, Ias, Ias, Ias, Ias, Ias, Ias, Ias
Ias, Ias, Ias, Ias, Ias, Ias, Ias, Ias^Xo, Ias^Xo, Ias^Xo, Ias^Xo, Cfr, Ias, Cfr, Ias^Xo, Ias^Xo, Ias^Xo, Ias^Xo, Ias, Ias, Ias, Ias, Ias, Ias, Ias, Ias
Ias, Ias, Ias, Ias, Ias, Ias, Ias, Ias, Ias, Ias^Xo, Ias^Xo, Ias^Xo, Ias^Xo, Ias^Xo, Ias^Xo, Ias^Xo, Ias, Ias, Ias, Ias, Ias, Ias, Ias, Ias, Ias, Ias
Ias, Ias, Ias, Ias, Ias, Ias, Ias, Ias, Ias, Ias, Ias, Ias^Xo, Ias, Ias^Xo, Ias, Ias, Ias, Ias, Ias, Ias, Ias, Ias, Ias, Ias, Ias, Ias
Ias, Ias, Ias, Ias, Ias, Ias, Ias, Ias, Ias, Ias, Ias, Ias, Ias, Ias, Ias, Ias, Ias, Ias, Ias, Ias, Ias, Ias, Ias, Ias, Ias, Ias
