Ias, Ias, Ias, Ias, Ias, Ias, Xoi, Ias, Ias, Ias, Ias, Ias, Ias
Ias, Ias, Ias, Ias, Xoi, Xoi, Xoi, Xoi, Xoi, Ias, Ias, Ias, Ias
Ias, Ias, Xoi, Xoi, Xoi, Xoi, Ias, Xoi, Xoi, Xoi, Xoi, Ias, Ias
Ias, Xoi, Xoi, Xoi, Cf, Cf, Ias, Cf, Cf, Xoi, Xoi, Xoi, Ias
Ias, Xoi, Xoi, Ias, Ias, Ias, Cf, Ias, Ias, Ias, Xoi, Xoi, Ias
Ias, Xoi, Xoi, Cf, Ias, Cf, 1 Kfr, Cf, Ias, Cf, Xoi, Xoi, Ias
Ias, Xoi, Xoi, Cf, Ias, Cf, Cf, Cf, Ias, Cf, Xoi, Xoi, Ias
Ias, Xoi, Xoi, Ias, Ias, Cf, Ias, Cf, Ias, Ias, Xoi, Xoi, Ias
Ias, Xoi, Xoi, Cf, Cf, Ias, Ias, Ias, Cf, Cf, Xoi, Xoi, Ias
Ias, Xoi, Xoi, Xoi, Xoi, Ias, Cf, Ias, Xoi, Xoi, Xoi, Xoi, Ias
Ias, Ias, Ias, Xoi, Ias, Ias, Ias, Ias, Ias, Xoi, Ias, Ias, Ias
Ias, Ias, Ias, Ias, Ias, Ias, Ias, Ias, Ias, Ias, Ias, Ias, Ias
Ias, Ias, Ias, Ias, Ias, Ias, Ias, Ias, Ias, Ias, Ias, Ias, Ias
