Isa, Isa, Isa, Isa, Isa, Isa, Isa, Isa, Isa, Isa, Isa, Isa, Xoi, Isa, Isa, Isa, Isa, Isa, Isa, Isa, Isa, Isa, Isa, Isa, Isa, Isa
Isa, Isa, Isa, Isa, Isa, Isa, Isa, Isa, Isa, Isa, Xoi, Xoi, Xoi, Xoi, Xoi, Isa, Isa, Isa, Isa, Isa, Isa, Isa, Isa, Isa, Isa, Isa
Isa, Isa, Isa, Isa, Isa, Isa, Isa, Isa, Xoi, Xoi, Xoi, Xoi, Ur, Xoi, Xoi, Xoi, Xoi, Isa, Isa, Isa, Isa, Isa, Isa, Isa, Isa, Isa
Isa, Isa, Isa, Isa, Isa, Isa, Isa, Xoi, Xoi, Xoi, Isa, Ur, Isa, Ur, Isa, Xoi, Xoi, Xoi, Isa, Isa, Isa, Isa, Isa, Isa, Isa, Isa
Isa, Isa, Isa, Isa, Isa, Isa, Isa, Xoi, Xoi, Isa, Isa, Ur, Ur, Ur, Isa, Isa, Xoi, Xoi, Isa, Isa, Isa, Isa, Isa, Isa, Isa, Isa
Isa, Isa, Isa, Isa, Isa, Isa, Isa, Xoi, Xoi, Cfr, Isa, Isa, Isa, Isa, Isa, Cfr, Xoi, Xoi, Isa, Isa, Isa, Isa, Isa, Isa, Isa, Isa
Isa, Isa, Isa, Isa, Isa, Isa, Isa, Xoi, Xoi, Cfr, Isa, Isa, Cfr, Isa, Isa, Cfr, Xoi, Xoi, Isa, Isa, Isa, Isa, Isa, Isa, Isa, Isa
Isa, Isa, Isa, Isa, Isa, Isa, Isa, Xoi, Isa^Xo, Isa, Isa, Cfr, 1 Kfr, Cfr, Isa, Isa, Isa^Xo, Xoi, Isa, Isa, Isa, Isa, Isa, Isa, Isa, Isa
Isa, Isa, Isa, Isa, Isa, Isa, Isa, Isa^Xo, Isa^Xo, Isa, Isa, Cfr, Cfr, Cfr, Isa, Isa, Isa^Xo, Isa^Xo, Isa, Isa, Isa, Isa, Isa, Isa, Isa, Isa
Isa, Isa, Isa, Isa, Isa, Isa, Isa, Isa^Xo, Isa^Xo, Isa^Xo, Isa^Xo, Cfr, Isa, Cfr, Isa^Xo, Isa^Xo, Isa^Xo, Isa^Xo, Isa, Isa, Isa, Isa, Isa, Isa, Isa, Isa
Isa, Isa, Isa, Isa, Isa, Isa, Isa, Isa, Isa, Isa^Xo, Isa^Xo, Isa^Xo, Isa^Xo, Isa^Xo, Isa^Xo, Isa^Xo, Isa, Isa, Isa, Isa, Isa, Isa, Isa, Isa, Isa, Isa
Isa, Isa, Isa, Isa, Isa, Isa, Isa, Isa, Isa, Isa, Isa, Isa^Xo, Isa, Isa^Xo, Isa, Isa, Isa, Isa, Isa, Isa, Isa, Isa, Isa, Isa, Isa, Isa
Isa, Isa, Isa, Isa, Isa, Isa, Isa, Isa, Isa, Isa, Isa, Isa, Isa, Isa, Isa, Isa, Isa, Isa, Isa, Isa, Isa, Isa, Isa, Isa, Isa, Isa
