Ms^Xm, Ms, Ms, Ms, Ms, Ms, Ms^Xm, Ms^Xm, Ms^Xm, Ms^Xm, Xu, Xu, Xu, Xu, Qxu, Qxu, Rb, Uu, Uu, Ur, Ur, Xu, Xu
Ms, Ms^Xm, Ms^Xm, Ms, Ms, Ms^Xm, Ms, Ms, Ms^Xm, Ms^Xm, Ms^Xm, Xu, Xu, Qxu, Qxu, Rb, Rb, Rb, Ur, Ur, Uu^Tf, Xu, Xu
Ms, Ms, Ms, Ms^Xm, Ms, Ms, Cha, Cha, Rra, Cha^Ebn, Ms^Xm, Ms^Xm, Xoi, Xu, Uu^Emf, Uu^Emf, Uh^Em, Uh^Em, Ur^Edb, Uu^Tf, Xu, Xu, Xu
Ms, Ms, Ms, Ms, Rra, Cha^Ebn, Rrc^Vhca, Aa, Rra, Gd^Esa, Cfa, Ms^Xm, Cfa, Xoi, Rb^Pw\o, Uu^Emf, Rb, Ur^Edb, Uu^Edb, Uu^Edb, Xu, Xu, Xu
Ms, Ms, Ms, Ms, Cha, Rra, Gd^Esa, 2 Gd^Esa, Rra, Gd^Esa, Rrc^Vhca, Cfa^Ebn, Aa, Aa, Rra, Rb^Pw\o, Ur^Pw\o, Rb, Xoi, Xu, Xu, Xu, Xu
Ms, Ms, Ms, Cha, Rra, Rra^Esa, 1 Rra, Cha, Rra^Vhca, Aa, Aa^Feta, Aa, Gd^Esa, Cha, Rra, Rra, Aa, Xoi, Ms^Xm, Xoi, Ms^Xm, Ms^Xm, Ms^Xm
Ms, Ms, Cha^Ebn, Cha, Kha, Gd^Esa, Rrc^Vhca, Rra, Rra, Rrc, Rrc, Aa, Rra^Vhca, Rra, Cha, Gd^Esa, Rrc^Vhca, Cfa, Ms^Xm, Ms^Xm, Ms^Xm, Ms^Xm, Ms
Ms, Ms, Aa, Aa^Feta, Rb^Eff, Rb^Eff, Rb^Eff, Kha^Esa, Cha^Ebn, Rrc^Vhca, Gd^Efm, Rrc, Rra^Vhca, 3 Kha, Rra, Gd^Fda, Aa, Cfa^Ebn, Cfa, Ms^Xm, Cha^Ebn, Ms, Ms
Ha, Ha, Rb^Eff, Rb^Eff, Rb^Gvs, Rd^Gvs, Re^Gvs, Rb^Eff, Rb^Eff, Cha^Esa, Kha^Esa, Gd^Fda, Aa, Cha, Gd^Esa, Rra, Aa, Rrc^Vhca, Rra, Ms^Xm, Cha, Ms, Ms
Rb^Eff, Rb^Eff, Re^Gvs, Re^Gvs, Rd^Gvs, Rd^Gvs, Rb^Gvs, Rb^Gvs, Re^Gvs, Rb^Eff, Rb^Eff, Aa, Rra, Rra, Cha, Rra, Cha^Ebn, Cha, Cha, Aa, Aa^Fpa, Ms, Ha
Rb^Eff, Rb^Eff, Rb^Eff, Re^Gvs, Rd^Gvs, Rb^Gvs, Rb^Gvs, Re^Gvs, Rb^Eff, Rb^Eff, Aa, Kha, Cha^Ebn, Cha, Aa, Rra, Aa, Aa, Aa, Aa^Fpa, Aa^Fpa, Ha, Aa
Rb^Gvs, Rb^Gvs, Rb^Gvs, Rb^Eff, Rb^Eff, Rd^Gvs, Rb^Eff, Rb^Eff, Rb^Gvs, Rb^Eff, Rb^Eff, Aa, Aa, Aa, Aa, Rra, Rra, Aa, Aa^Fpa, 4 Aa^Fpa, Aa^Fpa, Aa, Aa
Rb^Gvs, Rb^Gvs, Rb^Gvs, Rb^Gvs, Rb^Gvs, Rb^Eff, Rb^Gvs, Rb^Gvs, Rb^Gvs, Rb^Gvs, Rb^Gvs, Rb^Eff, Rb, Aa, Aa, Aa, Gg, Rra, Gg, Aa^Fpa, Aa^Fpa, Aa^Fpa, Gg
